abandon	…を捨て去る
able	できる，有能な
abroad	外国へ
abroad	外国で，外国へ
absence	不在，欠如
absent	欠席の
absolute	絶対的な，完全な
absolutely	絶対に
absorb	…を吸収する，…を没頭させる
abstract	抽象的な
accent	（ことばの）なまり，抑揚
accept	…を受け入れる
acceptance	受け入れ
access	アクセス，使用［閲覧］する機会［権利］
accident	事故
accompany	…に付き添う
accomplish	…を成し遂げる
account	説明，口座／説明する，占める
accurate	正確な
accuse	…を非難［告発］する
accustomed	慣れている
achieve	…を達成する
acknowledge	…の存在［正しさ］を認める
acquaintance	知り合い
acquire	…を身につける
across	横にさし渡し，横切って
action	行動
action	動作，行動
activity	活動
actual	現実の，実際の
actually	実際に，現実に
adapt	…を適合［適応］させる
add	加える
add	…を付け加える
addition	付加，追加
additional	追加の
address	住所
address	住所，演説／…の前で演説をする
adequate	十分な
adjust	…を調節する，順応する
admire	…をすばらしいと思う，…を賞賛する
admit	…を認める
adopt	…を自分のものにする
advance	前進する／前進，事前
advantage	有利，利点
advertise	…を宣伝［広告］する
advice	忠告
advice	助言
advise	忠告する，助言する
advise	…にアドバイスする［勧める］
affair	事柄，出来事
affect	…に影響を与える
affection	愛情
afford	…の余裕がある
afraid	恐れて
afraid	心配して，怖がって
after	～の後で
afternoon	午後
again	再び
age	年齢，時代
agent	代理人，代理店
aggression	攻撃性
aggressive	攻撃的な，積極的な
ago	前
agree	同意する，賛成する
agreement	同意，一致
agriculture	農業
ahead	前方に
aid	援助／…を助ける
aim	ねらいをつける／目的
air	空気
airport	空港
alarm	懸念／…に懸念を抱かせる
album	アルバム
alike	よく似た
alive	生きている
all	みんな
all	すべての
all	まったく
allow	…を許可する，…が～するのを許す
almost	ほとんど
alone	ひとりきりで
aloud	声に出して
already	すでに
also	もまた
alter	…を変える
alternative	代替となるもの／代替の
although	であるけれど
although	…だけれども
altogether	完全に
always	いつも
amazing	びっくりするような
ambition	夢，大望
America	アメリカ
American	アメリカの
amount	量，額
amuse	…を楽しませる
analyze	…を分析する
ancestor	祖先
ancient	古代の，大昔の
and	～と
anger	怒り
angry	怒って
animal	動物
annoy	…をいらだたせる
annual	毎年の
another	ほかの，もうひとつの
answer	答える
answer	答え
anxiety	心配，不安
anxious	心配して，切望する
anyway	ともかく
apart	離れて
apparent	外見上の，明らかな
appeal	訴える
appear	現れる，…のように思われる
appearance	出現，外見
appetite	食欲
apple	りんご
application	応用，適用
apply	…を適用する，当てはまる
appointment	約束
approach	…に近づく
appropriate	適当な，適切な
April	４月
area	地域
area	地域，面積
argue	（感情的に）論じる，…だと主張する
arise	起こる，生じる
arm	腕
arms	武器，兵器
army	陸軍
arrange	（…を）計画・準備する
arrangement	準備，取り決め
arrive	到着する
arrow	矢
art	美術，芸術
artificial	人工的な
artist	芸術家
ashamed	恥じて
Asia	アジア
ask	たずねる，頼む
asleep	眠っている
aspect	局面
associate	…を結びつけて考える
association	協会，組合
assume	…を当然のことと思う，…を引き受ける
assumption	想定，思いこみ
assure	…に～だとして安心させる
astonish	…をびっくりさせる
athlete	運動選手
Atlantic	大西洋の
atmosphere	雰囲気
atomic	原子の，原子力の
attach	…を貼り付ける，…を取り付ける
attempt	試み／…を試みる
attend	…に出席する
attitude	考え方，態度
attract	…を引きつける
attractive	魅力的な
audience	聴衆，観客，視聴者
August	８月
Australia	オーストラリア
author	著者，作家
authority	権威
automobile	自動車
autumn	秋
available	利用できる，人の手があいている
avenue	…通り，大通り
average	平均の／平均
avoid	…を避ける
awake	目が覚める
awake	目を覚ましている
aware	気づいている
away	離れて
awful	ひどい
baby	赤ん坊
back	裏の，後ろの
background	背景，経歴
bad	悪い
badly	ひどく，悪く
bag	カバン
bake	オーブンで焼く
ball	ボール
band	バンド
band	（音楽の）バンド，一団
bar	棒，横木
barber	床屋
barely	かろうじて
baseball	野球
based	基づいている
basic	基本的な，基礎的な
basis	土台，基礎
basketball	バスケットボール
bat	バット
bath	風呂
bathroom	浴室
beach	砂浜
bear	クマ
bear	…を我慢する
beat	…をうち負かす
beautiful	美しい
beauty	美
because	なぜなら
become	～になる
bed	ベッド
beef	牛肉
beer	ビール
beg	…を乞う
begin	始まる(める)
behave	振る舞う
behavior	行動，振る舞い
behind	…の背後に／背後に
behind	…の背後に／背後に
believe	信じる
bell	ベル
belong	ものである
belong	属する
belt	ベルト
bench	ベンチ
bend	…を曲げる
beneath	…の下に
benefit	利益／…に利益をもたらす
besides	その上
best	一番良い
between	～と～の間
bicycle	自転車
big	大きい
bill	請求書，紙幣，法案
billion	１０億
bind	…を縛りつける
biological	生物学上の
bird	鳥
birth	誕生
birthday	誕生日
bit	少し
bite	…を噛む，…を刺す
black	黒い
blind	目の見えない
blink	まばたきをする／まばたき
block	…を妨げる
blood	血
blood	血
blow	吹く
blow	（…を）吹く／打撃
blue	青い
boat	ボート
body	身体
boil	ゆでる，煮る
bomb	爆弾
book	本
border	国境
bored	退屈した
borrow	借りる
borrow	…を借りる
both	両方
bottle	びん
bow	お辞儀をする／お辞儀
bowl	鉢
box	箱
brain	頭脳
branch	枝
brave	勇敢な
bread	パン
break	壊れる，破る
breakfast	朝食
breathe	呼吸をする
bridge	橋
brief	短い
bright	明るい
brilliant	すばらしい
bring	持って来る
broadcast	…を放送する
brown	茶色の
brush	筆
build	建てる
building	建物
burden	重荷，負担
burst	破裂する，…を破裂させる
bury	…を埋める
bus	バス
business	商売
busy	忙しい
but	しかし
butter	バター
buy	買う
cake	ケーキ
calendar	カレンダー
call	電話をかける
calm	落ちついた
calm	穏やかな，落ち着いた
camera	カメラ
camp	キャンプ
campaign	政治的運動
can	カン
Canada	カナダ
candidate	候補者，志願者
candle	ろうそく
candy	キャンディー
cap	帽子
capable	可能性がある，しかねない，有能な
capacity	最大容量［積載量・稼働力］，能力
capital	首都
capital	資本，資本金，首都／大文字の
captain	船長
capture	…を捕える
car	自動車
card	カード
care	気にする
care	世話，管理
care	気にかける／注意，関心
career	(生涯にわたる）職業
careful	注意深い
carefully	注意深く
carpet	じゅうたん
carry	運ぶ
case	場合，容器
case	場合，事例
cash	現金
casual	何気ない
cat	猫
catch	捕まえる，(列車に)間に合う
catch	…に乗るのに間に合う，…が～しているのを見つける
category	部門，部類
cause	原因／…の原因となる，…に～させる
cave	ほら穴
cease	…をやめる，終わる
celebrate	…を祝う
cell	細胞
cent	セント
center	中央
centimeter	センチメートル
central	中心の
century	世紀
certain	ある
certain	ある…，確信している
certainly	確かに
chain	くさり
chair	いす
chalk	チョーク
challenge	挑戦，難題／…に異議を唱える
chance	機会
chance	機会，可能性，偶然
change	変わる
character	性格，特質
characteristic	特徴
characterize	…を特徴づける
charge	非難，料金，管理／…に請求する
charm	魅力／…を魅了する
cheese	チーズ
chemical	化学の／化学製品
chicken	ニワトリ
child	子供
China	中国
Chinese	中国の，中国人の
choice	選択（肢）
choose	選ぶ
Christmas	クリスマス
circle	円
circumstance	（周囲の）状況
citizen	市民
civil	公民の，（軍事に対し）民間の
civilization	文明
civilized	発達した文明をもつ
claim	…が自分のものだと主張する
class	学級，授業
class	階級，等級，授業，学級
classical	古典の，古典的な
classroom	教室
clean	きれいな
clean	掃除する
clerk	事務員
clever	利口な
climate	気候
climate	気候
climb	登る
cling	しがみつく，固執する
clock	置き時計
close	閉じる
close	接近した
close	近い，親密な
closely	綿密に，密接に
cloth	布
clothes	服
cloud	雲
cloudy	曇った
club	クラブ
coat	コート
coffee	コーヒー
coin	硬貨
cold	冷たい，寒い
colleague	同僚
collect	集める
collect	…を集める，…を徴収する
college	大学
colony	植民地
color	色
combine	…を結合させる
come	来る
comfortable	心地の良い
command	…に［を］命じる／行使する力
commit	＜罪など＞を犯す
committee	委員会
common	共通の
common	一般的な，共通の
commonly	一般に
communicate	意思を伝える，…を伝達する
communication	コミュニケーション，意思の伝達
community	共同社会
companion	連れ，仲間
company	会社，仲間
compare	…を比較する，…をたとえる
comparison	比較
compete	競争する
competition	競争，競争相手
complain	不満を言う
complaint	不満
complete	完全な
complex	複雑な
complexity	複雑さ
complicated	複雑な
compose	…を構成する，＜曲や詩＞を作る
composition	構成，楽曲
computer	コンピュータ
concentrate	集中する
concerned	関わっている，心配している
concert	コンサート
conclude	締めくくる，…という結論を下す
conclusion	結論
condition	状態，条件
conduct	行為／…を行う
conference	会議
confidence	自信，信頼
confine	…を限る，…を閉じこめる
confirm	…を確認する
conflict	対立，争い
confront	…を直面させる
confuse	…を混乱させる
confusion	混乱
connect	…をつなげる
conscious	意識して，気づいて
consequence	結果
consequently	その結果
consider	…について考える，…を～だと見なす
considerable	かなりの
consist	成り立つ，存在する
constant	絶え間ない
constantly	常に
constitute	…を構成する
construct	…を組み立てる，…を建造する
construction	建設，構造
consume	…を消費する
consumption	消費
contact	…と連絡をとる／接触，連絡
contain	…を含む，…が入っている
contemporary	現在の，現代の，同時代の
content	中身，目次／満足して
contest	コンテスト
continent	大陸
continue	…を続ける
contract	契約
contrary	反対の
contrast	対照
contribute	寄付する，貢献する
contribution	寄付，貢献
control	支配，制御／…を支配［制御］する
convenient	都合がよい
convention	しきたり，（大規模な）会議
conversation	会話
convert	…を変える，変わる
convey	…を伝える，…を運ぶ
convince	…に納得させる
cook	料理する
cool	涼しい
cooperation	協力
cope	対処する
copy	模写する
copy	（本・雑誌などの）一冊／…をまねる
corner	かど
correct	正確な／…を訂正する
cost	…を（費用として）必要とさせる／費用
count	重要である，数える
couple	一対
courage	勇気
courage	勇気
course	進路
cousin	いとこ
cover	おおう
cover	…を覆う，…（の範囲を）カバーする
cow	雌牛
crash	衝突／衝突する
crazy	気の狂った
create	…を作り出す，…を創造する
creation	創造，創造物
creative	創造的な
crew	乗組員，一団
crime	犯罪
crisis	危機
critic	批評家，批判者
critical	極めて重要な，非常に深刻な
criticism	批判
criticize	…を批判する
crop	収穫物
cross	横切る
cross	…を横切る／不機嫌な
crowd	群衆
crowd	群衆，人混み
cry	泣く
cultivate	…を耕作する，…を栽培する
culture	文化
culture	文化
cup	カップ
cure	…を治療する
curiosity	好奇心
curious	好奇心が強い
current	現在の，目下の／流れ
curtain	カーテン
custom	習慣
custom	（社会的な）習慣，慣習
customer	顧客
cut	切る
cute	可愛い
dad	お父ちゃん
daily	毎日の
damage	被害
damage	損害／…に損害を与える
dance	踊る
danger	危険
dare	思い切って…する，生意気にも…する
dark	暗い，黒い
date	日付
date	デートする
day	日
dear	親愛なる
death	死
debate	討論
debt	借金，負債
decade	１０年
December	１２月
decide	決心する
decision	決定，決心
declare	…を宣言する
decline	…を断る，衰退する／低下，衰退
decrease	減少する／減少
deep	深い
defeat	…を負かす
defend	…を守る
define	…の意味を明確に述べる
definite	明確な
definition	定義
degree	程度，度
delay	…を遅らせる
deliberately	故意に
delicate	微妙な
delicious	おいしい
delight	喜び
deliver	…を配達する
demand	要求，需要／…を要求する
democracy	民主主義
democratic	民主主義の，民主的な
deny	…を否定する
depend	依存する，次第である
dependent	依存している
depress	…を落胆させる
derive	…を引き出す
describe	…について述べる，…を描写する
description	説明，描写
desert	砂漠
desert	砂漠／…を立ち去る
desirable	望ましい
desire	願望／…を強く望む
desk	机
despite	…にもかかわらず
destroy	破壊する
destroy	…を破壊する
destruction	破壊
detail	詳細
determine	…を決める
develop	…を発達［発展］させる，発達する
development	発展，発達
device	装置，仕掛け
devise	…を考え出す
devote	＜時間・努力＞を注ぐ
dialect	方言，なまり
diary	日記
dictionary	辞書
die	死ぬ
die	死ぬ
diet	（日常の）食事，ダイエット
difference	違い
different	違った
difficult	むずかしい
difficulty	困難，苦労
dignity	威厳，尊厳
diminish	減る，…を減らす
dinner	夕食
direct	直接の
direction	方向，方角
directly	直接（的）に
dirty	汚れた
disadvantage	不利，デメリット
disagree	一致しない
disappear	消える
disappoint	…をがっかりさせる
disaster	災害
discipline	しつけ，規律
discourage	…をがっかりさせる
discover	発見する
discover	…を発見する
discuss	話し合う
discuss	…について議論する
discussion	討論
discussion	議論
disease	病気
disease	病気
dish	皿，料理
dislike	嫌う
dislike	…を嫌がる／嫌悪
display	…を展示する／展示
dispute	争議，口論
distance	距離
distant	遠く離れた
distinct	はっきり異なる
distinction	区別，違い
distinguish	…を区別する
district	地域，地区
disturb	…の平穏を妨げる
divide	…を分割する
division	分割，部門
divorce	離婚
do	する
document	文書
dog	犬
doll	人形
dollar	ドル
domestic	国内の，家庭内の
dominate	…を支配する
door	ドア
doubt	疑い／…を疑う
down	下に
dramatic	劇的な
draw	描く，引く
draw	…を引きつける
dream	夢
dress	着る
dressed	服を身につけた
drink	飲む
drive	運転する
driver	運転手
drop	落とす
drug	麻薬，薬
dry	乾く
duck	あひる
due	行われる［到着する］予定である
dull	面白みのない，鈍い
dumb	口のきけない
during	～の間，～を通じて
dwell	住む
each	おのおのの
eager	強く望んでいる
ear	耳
early	早い
early	早く
earn	…を稼ぐ
earth	地球，大地
easily	かんたんに
east	東
easy	やさしい，気楽に
eat	食べる
ecology	生態（学）
economic	経済の，経済的な
economics	経済学
economy	経済
editor	編集者
educate	…を教育する
education	教育
educational	教育の，教育的な
effect	効果，影響，結果
effective	効果的な
effectively	効果的に
efficient	効率［能率］の良い
egg	卵
eight	8
eighteen	18
eighteenth	１８番目の
eighth	8番目の
eighty	80
either	(もまた)～でない
elaborate	手の込んだ
elderly	年配の
electrical	電気の
element	要素
elementary	初歩の，基本の
elephant	象
elevator	エレベーター
eleven	11
eleventh	11番目の
eliminate	…を取り除く
else	そのほかに
embarrass	…を恥ずかしがらせる，…にばつの悪い思いをさせる
emerge	現れる
emotion	感情
emotional	感情の，感情的な
emperor	皇帝，天皇
emphasize	…を強調する
employ	…を雇う
employee	従業員
empty	何も入っていない，空の
enable	…に可能にさせる
encounter	…に遭遇する
encourage	…を励ます，…を助長する
end	終わる
endure	…に耐える
enemy	敵
enemy	敵
energy	エネルギー
engaged	従事している，婚約している
engineer	エンジニア
England	イングランド
English	英語
enjoy	楽しむ
enormous	非常に大きい
enough	十分な
ensure	…を確実にする，…を保証する
enter	入る
enter	…に入る
enterprise	会社，事業
entertain	…を楽しませる
entertainment	娯楽
enthusiasm	情熱，熱意
entire	全体の，…全体
entirely	完全に，全く
entrance	入り口，入学
environment	環境
environmental	環境の
equal	等しい／…に等しい
equality	平等
equip	…に備え付ける［身につけさせる］
equivalent	等しい，同等の
era	時代
eraser	消しゴム
error	ミス，間違い
especially	特に
especially	特に
essential	不可欠な
essentially	本質的に
establish	…を設立する
estimate	…を推定する，…を見積もる／推定
Europe	ヨーロッパ
even	～さえ
evening	晩
event	出来事，行事
eventually	最終的には
ever	今まで
every	毎～
everybody	だれでもみな
everyone	みんな
everything	すべてのもの
everywhere	どこでも
evidence	証拠
evident	明らかな
evil	邪悪な，悪の
evolution	進化，進展
evolve	進化する
exact	正確な
exactly	正確［厳密］に，ちょうど
exam	試験
examine	…を検査する，…を調べる
example	例
except	…を除いて
exception	例外
excessive	過度の
exchange	交換／…を交換する
excite	…を興奮させる
excited	興奮した
exciting	興奮させる
excuse	許す
excuse	言い訳／…勘弁する
executive	幹部，重役
exercise	練習する
exercise	運動，練習／運動をする
exhaust	…を疲れ果てさせる，…を使い果たす
exhibit	…を表に出す，…を展示する，
exist	存在する
expand	…を拡大する
expect	…を予想する，…を期待する
expense	費用，出費，犠牲
expensive	値段が高い
experience	経験／…を経験する
experiment	実験
expert	専門家
explain	説明する
explain	…を説明する
explanation	説明　
explore	…を探索［探検］する
explosion	爆発
export	…を輸出する／輸出
expose	…を明らかにする，…をさらす
express	…を表現する
expression	表現
extend	延びる，…を拡張する
extent	程度
external	外部の
extinction	絶滅
extra	余分の
extraordinary	普通でない，並はずれた
extreme	極端な
extremely	極端に
eye	目
face	顔
face	…に直面する
facility	施設，設備
fact	事実
fact	事実
factor	要因，要素
factory	工場
fail	失敗する
fail	失敗する
failure	失敗，失敗作，失敗者
fair	公平な，かなりの
fairly	かなり，公平に
fairy	妖精
faith	信頼，信仰
fall	秋
fall	落ちる
familiar	馴染みのある
famous	有名な
famous	有名な
fan	ファン
far	遠くに，はるかに
farm	農場
farmer	農場主
fascinate	…を魅了する
fast	速い
fast	速く
fat	太った
fat	太った／脂肪
fate	運命
fault	欠点，過失，せい
favor	親切な行為
favorite	一番好きな，一番好きなもの
fear	…を恐れる／恐れ
feature	特徴／…を目玉とする
February	２月
feed	…に食べ物を与える，…を養う
feel	感じる
feeling	感覚
female	雌の，女性の／雌，女性
fence	塀
festival	祭り
few	(aをつけ)少数の
field	分野，領域，野原，畑
fifteen	15
fifteenth	１５番目の
fifth	5番目の
fifty	50
fight	戦う
figure	数字，姿，人物
fill	いっぱいにする
film	映画
final	最後の
finally	ついに
financial	財政の，金融の
find	見つける，～とわかる
fine	すばらしい，元気な，晴れた
fine	うまく
finger	指
finish	終える
fire	火
fire	…を首にする
firm	しっかりした，堅い／会社
firmly	堅く，堅固に
first	1番目の
fish	魚
fishing	魚釣り
fit	…に適合する／適した
five	5
fix	…を固定する，…を修理する
flame	炎
flat	平らな
flight	飛行
flight	飛行，（飛行機の）便
float	浮かぶ
flow	流れる／流れ
flower	花
fly	飛行機で行く，飛ぶ
focus	焦点／…を集中する
fold	…を折りたたむ
follow	…の後を追う
fond	好きで
food	食べ物
fool	馬鹿
foolish	愚かな
foot	足
football	フットボール
force	力／…を［に］強制する
foreign	外国の
forest	森林
forever	永久に
forever	永遠に
forget	忘れる
fork	フォーク
form	形態／…を形成する
former	前の／前者
forth	4番目の
fortune	運，財産
forty	40
forward	前方へ
found	…を設立する
foundation	土台，根拠，設立
four	4
fourteen	14
fourteenth	１４番目の
fox	キツネ
free	自由な，ひまな
free	束縛のない，無料の，暇な
freedom	自由
frequent	頻繁な
frequently	頻繁に
fresh	新鮮な
Friday	金曜日
friendly	好意的な
friendly	友好的な
frighten	…をおびえさせる，…を怖がらせる
frog	カエル
front	前
frontier	国境，辺境
fruit	果物
fuel	燃料
fulfill	…を果たす，…をかなえる
full	いっぱいの
full	いっぱいの，満腹である
fully	十分に，完全に
fun	楽しみ
function	機能／機能する
fund	資金，基金
fundamental	基本的な，根本的な
funeral	葬式
funny	おかしな
fur	毛皮
furniture	家具，調度品
future	未来
gain	…を得る／獲得
game	試合
garbage	（生）ゴミ，くず
gas	ガス
gather	…を集める，集まる
gaze	じっと見つめる
gene	遺伝子
general	一般的な，全般的な
generally	一般的に
generate	…を発生させる
generation	世代
generous	気前のよい
genius	天才
gentle	やさしい
gentle	穏やかな，やさしい
gentleman	紳士
gently	やさしく
genuine	本物の，偽りのない
get	得る，着く，乗る
get	…になる，…を手に入れる
gift	贈り物
give	与える，(会などを)開く
glad	うれしい
glass	コップ，ガラス
global	地球の，世界の
globe	地球
glove	グローブ
go	行く
goal	得点，ゴール
goal	目標，目的
God	神
god	神
gold	金
good	良い
goods	商品
govern	…を統治する
government	政府，統治
grade	評点，等級
gradually	次第に
graduate	卒業する
gram	グラム
grammar	文法
grand	壮大な
grandfather	祖父
grandmother	祖母
grant	給付金／…を与える
grape	ブドウ
grasp	…をつかむ，…を理解する
grass	草
grave	墓／深刻な
gray	灰色
great	すばらしい，広大な
green	緑の
greet	…にあいさつをする
ground	地面
ground	根拠，理由
group	グループ
grow	成長する，になる，増加する，育てる，栽培する
growth	成長
guarantee	…を保証する
guard	…の警護［監視］をする／警護者，監視者
guess	…だと思う，…を推測する／当てずっぽう
guest	客
guide	案内人
guide	案内人，案内書／…を案内する
guilty	有罪の
guitar	ギター
gun	鉄砲
gym	体育館
habit	習慣
habit	（個人の）習慣，癖
hair	髪
half	半分
hall	玄関の広間，ろうか
hand	手
hand	手渡す
handle	…を手で扱う，…にうまく対処する
hang	…をつるす，…を絞首刑にする
happen	起こる
happily	幸せに，楽しく
happiness	幸福
happy	幸福な，楽しい
hard	いっしょうけんめい
harm	害／…を害する
harmful	有害な
harmony	調和
harvest	収穫／…を収穫する
hat	帽子
hate	…をひどく嫌う
have	持っている，食べる
he	彼は
head	頭，先頭
health	健康
healthy	健康な
healthy	健康（的）な
hear	聞く
heart	心
heaven	天
heavy	重い，大量の
height	高さ
hello	こんにちわ
help	助ける
her	彼女の
her	彼女を（に）
here	ここに
hers	彼女のもの
herself	彼女自身
hesitate	ためらう
high	高い
highly	とても，高く
hill	丘
him	彼を(に)
himself	彼自身
hire	…を雇う
his	彼の
his	彼のもの
historical	歴史（上）の
history	歴史
history	歴史
hit	打つ
hit	…を叩く
hobby	趣味
hold	握る，開催する，差し出す
hold	…を（一時的に）持っている
hole	穴
holiday	休日
holy	神聖な
home	家を(へ)
home	故郷，家
homeroom	ホームルーム
homework	宿題
honest	正直な
honest	正直な
honey	蜂蜜
honor	名誉，敬意
hope	希望
hope	望む
horse	馬
host	主人
hot	暑い
hour	時間
household	（一つ屋根の下で暮らす）家族，家
how	どのくらい
however	しかし
however	しかしながら
huge	巨大な
human	人間の
human	人間の／人間
humanity	人間，人間性
hundred	百
hunger	飢え，空腹
hungry	空腹の
hunt	狩りをする
hunt	捜し求める
hurry	急ぐ
hurt	傷つける
hurt	…を傷つける
husband	夫
I	私は(が)
ice	氷
idea	考え
idea	考え，思いつき
ideal	理想／理想の
identical	全く同じ
identify	…を見分ける
if	もし
ignore	…を無視する
ill	病気の
illustrate	…を詳しく説明する
imagination	想像
imagine	想像する
imagine	…を想像する
imitate	…を模倣する
immediate	即座の
immediately	即座に
immigrant	移民
immigration	（他国からの）移住
impact	影響，衝撃
imply	…をほのめかす
import	…を輸入する／輸入
important	重要な
impose	…を課す
impossible	不可能な，だめな
impress	…に感銘を与える
impression	印象
improve	…を改善する
impulse	衝動
incident	事件
inclined	傾いている，傾向がある
include	…を含む
income	所得
increase	…を増やす，増える
increasingly	ますます
indeed	実に
indeed	確かに
independence	独立，自立
independent	独立した，自立した
indicate	…を指し示す
individual	個人の，個々の／個人
industrial	産業の，工業の
industrialize	…を産業化［工業化］する
industry	産業，工業
inevitable	避けられない
infant	幼児
inferior	劣った
influence	…に影響を及ぼす／影響
inform	…に知らせる
information	情報
inhabitant	（ある場所の）居住者，生息動物
initial	当初の
injury	けが
ink	インク
inner	内部の
insect	昆虫
inside	内側
insight	深く正確な理解，洞察（力）
insist	要求する，主張する
inspire	…を鼓舞する
instinct	本能
institution	制度，慣習，（重要な）施設
instruction	指示，指導
instrument	道具，器具
insurance	保険
intellectual	知的な，知性の
intelligence	知能，諜報
intelligent	知能の高い
intend	意図する，つもりである
interested	興味のある
interesting	おもしろい
interfere	干渉する，阻害する
internal	内部の
international	国際的な
international	国際的な
interpret	…を解釈する，通訳する
interrupt	…の邪魔をする，…を中断させる
intimate	親密な
introduce	紹介する，初めて伝える
introduce	…を紹介する，…を導入する
introduction	紹介，導入
invent	発明する
invent	…を発明する
investigate	（…を）調査する
investment	投資
invisible	見えない
invite	招待する
involve	…を含む，…を巻き込む
iron	鉄
island	島
isolate	…を孤立させる
issue	問題，（雑誌などの）号／…を出す
it	それは
it	それを(に)
item	項目
its	それの
itself	それ自身
jam	ジャム，混雑
January	１月
jeans	ジーンズ
jewel	宝石
job	仕事
join	参加する
journey	旅
joy	喜び
joy	喜び
judge	…を判断する／審判員，裁判官
judgement	判断
juice	ジュース
July	７月
jump	跳ぶ
June	６月
junior	年下の，下級の
junior	ポストが下の，下級の／年下の人
just	ちょうど，ただ単に
justify	…を正当化する
keen	切望した，熱意のある
keep	保つ，～を(持ち)続ける
key	鍵
kid	子供／（…を）からかう
kill	殺す
kilometer	キロメートル
kind	親切な
kind	種類
king	王様
kiss	キスをする
knife	ナイフ
knock	ノックする
know	知っている
knowledge	知識
labor	労働
laboratory	実験室
lack	不足，欠落／…がない
lady	婦人
lake	湖
land	陸地，土地
landscape	風景
language	言語
language	ことば，言語
large	大きい，広い
largely	主として
last	最後
last	この前の，最後の
later	後で
later	後に，…後
latest	最新の，最近の
latter	後者の
laugh	笑う
laughter	笑い
law	法律
law	法律，法則
lay	…を横たえる
lazy	怠け者の
lead	…の先頭に立つ，つながる
leaf	葉
leap	跳ぶ
learn	学ぶ，覚える
leave	去る，残す，置いて行く
left	左
leg	脚
legal	法律の，合法な
leisure	余暇
lemon	レモン
lend	貸す
lesson	授業，課
lesson	授業，教訓
letter	手紙
level	レベル，水準，程度
liberal	（他の思想に）寛大な，自由主義的な
liberty	自由
lie	嘘
lie	横たわる，～にある
lie	横たわる，嘘をつく
life	生活，生命，人生
life	生活，人生，生命
light	光，明かり，信号
light	薄い
like	好む
likely	可能性が高い
limit	限度，制限／…を制限する
limitation	制限，制約
line	線，列
line	行，列
lion	ライオン
lip	くちびる
list	リスト
listen	聴く
literally	文字通りに
literary	文学の
literature	文学
little	小さい，幼い，ちょっとした
live	住む，生きる
living	生きている
load	積み荷／…を積む
local	地元の
located	（ある場所に）位置する
location	位置，場所
locker	ロッカー
logic	論理，理屈
logical	論理的な
London	ロンドン
lonely	淋しい，ひとりの
long	長い
long	長く
long-term	長期的な
look	見る，～に見える
lord	封建君主，…卿，（（大文字で））神
lose	失う，負ける
lose	…を失う，負ける
loss	失うこと，損失
lost	道に迷った。
lot	たくさん
loud	(声の)大きい
love	愛，愛する人
love	愛する
lovely	美しい
low	低い
luck	運
luck	運，幸運
lucky	好運な
lunch	昼食
lung	肺
luxury	贅沢，贅沢品
machine	機械
magazine	雑誌
mail	郵便
mail	郵便／…を投函する
main	主な
maintain	…を維持する，…だと主張する
major	主な，大きな／専攻する
majority	大多数，大半
make	作る，～を～にする
mammal	哺乳動物
manage	何とかうまくやる，管理を行う
manager	部長，支配人，監督
manner	やり方，方法
manufacture	製造する
many	多くの
map	地図
March	３月
mark	印
mark	しるし，（試験の）点数／…の印となる
market	市場
market	市場
married	結婚した，既婚の
marry	結婚する
marry	…と結婚する
mass	塊，集団，大衆
massive	巨大な，大規模な
master	主人，達人／…を習得する
match	試合
match	試合／…と調和する
material	材料，原料／物質（的）な
math	数学
matter	問題，困ったこと
matter	事柄／重要である
mature	成熟した
May	５月
maybe	おそらく
maybe	たぶん，五分五分で
me	私を
meal	食事
meal	食事
mean	意味する
mean	…を意味する，…を意図する
meaning	意味
measure	措置，測るもの／…を測る
meat	肉
mechanical	機械の，機械的な
medal	メダル
medical	医学の，医療の
medicine	薬
medium	中間の
meet	会う
melon	メロン
melt	溶ける，…を溶かす
member	会員
mental	精神の，知的な
mention	…について言及する
menu	メニュー
merchant	商人
merchant	商人
merely	単に
merry	陽気な
meter	メートル
method	方法
middle	中央
midnight	真夜中
mile	マイル
military	軍隊の，軍事の
milk	牛乳
million	１００万
million	百万
mind	精神
mind	アタマ，思考／…を嫌がる
mine	私のもの
mineral	鉱物
minor	小さな，重要度の低い
minority	少数派
minute	分，ちょっとの間
mirror	鏡
miss	間違う，いなくてさみしく思う
miss	…が（い）ないのを寂しく思う，…に乗り損なう，ミスする
mistake	誤り
mistake	誤り／…を～と間違える
misunderstand	…を誤解する
mitt	ミット
mix	混ぜる
model	模型
modern	現代的な
modern	現代の，近代の
mom	おかあちゃん
moment	瞬間，時
Monday	月曜日
money	お金
monkey	サル
month	月
monthly	月刊
mood	気分
moon	月
morning	朝
most	ほとんど
most	大半／最も…
motive	動機
mountain	山
mouse	はつかねずみ
mouth	口
move	動く，感動させる
movement	動き，（政治的・社会的）運動
much	ずっと，たいへん
much	多量の
murder	(故意の）殺人／…を（故意に）殺す
museum	博物館
music	音楽
musical	音楽の
mutual	相互の
my	私の
myself	私自身を
mysterious	不可解な
myth	神話
name	名前
name	名づける
narrow	幅が狭い
nation	国家，民族，国民
national	国家の，国民の
national	国の，国立の
native	生まれ故郷の，生来の
natural	自然の
natural	当然の，自然の
naturally	当然，自然に
nature	自然
nature	自然，性質
nearby	近くの
necessarily	必然的に
necessary	必要な
necessary	必要な
necessity	必要，必要なもの
neck	首
need	必要な
negative	否定の，否定的［悲観的］な
neglect	…の世話を怠る，…を省みない
neighbor	隣人
neighbor	近所の人
neighborhood	近所
neither	～も～も(ない)
nerve	神経
nervous	あがっている，神経質な
nest	巣
net	網
never	１度も～ない
nevertheless	にもかかわらず
new	新しい
news	ニュース
newspaper	新聞
next	次の，隣の
nice	すばらしい
night	夜
nine	9
nineteen	19
nineteenth	１９番目の
ninety	90
ninth	9番目の
no	いいえ
nobody	だれも～ない
nod	うなずく
noise	物音
noisy	騒がしい
none	何も(だれも)～ない
noon	正午
normally	通常は，正常に
north	北
nose	鼻
not	～でない
note	メモ／…に注目［注意］する
notebook	ノート
nothing	何も～ない
notice	…に気づく／注意，掲示
notion	考え，考え方
novel	小説／新奇な
November	１１月
now	今
nuclear	核の
number	数
numerous	多数の
object	物体，対象，目的／反対する
obligation	義務
observation	観察
observe	…を観察する，…を遵守する
obtain	…を手に入れる
obvious	明白な
obviously	明らかに
occasion	（特定の）時，場合
occasionally	時折
occupation	職業
occupy	…を占める，…を占領する
ocean	大洋
o'clock	～時
October	１０月
odd	変な，奇数の／（（oddsで））可能性
off	離れて
offend	…の気分を害する
offer	…を申し出る／申し出
office	会社，仕事部屋，公職の地位
often	しばしば
oil	油
old	年をとった，古い
once	かつて，１度
one	1
open	開ける
open	開いている
operation	操作，運転，手術
opinion	意見
opportunity	機会
oppose	…に反対する
opposite	反対の／…と反対側の
or	それとも
orange	オレンジ
orbit	軌道
order	注文する
order	命令，秩序／…に命じる，…を注文する
ordinary	普通の
organization	組織，団体
organize	…を組織する
origin	起源
original	当初の／原文
originate	起こる，生じる
other	ほかの
otherwise	さもなければ，それとは違うように
our	私たちの
ours	私たちのもの
ourselves	私たち自身を
output	生産量，産出量
outside	外側の
overcoat	オーバー
overcome	…を克服する
overlook	…を見落とす，…を見過ごす
overwhelming	圧倒的な
owe	…に金を借りている
own	自分の
own	自身の／…を所有している
owner	所有者
page	ページ
pain	痛み
pain	痛み
painful	苦痛な
paint	描く，(～に)ペンキを塗る
painter	画家
pair	一組
pal	友だち
palace	宮殿
pale	青ざめた
pants	ズボン
paper	紙，レポート
paper	新聞，書類，レポート，論文
part	部分
participant	参加者
participate	参加する
particular	特定の，特にその，気むずかしい
particularly	特に
party	パーティー
party	政党，当事者
pass	過ぎる，合格する，手渡す
passage	（文章の）一節，通路
passenger	乗客
passion	熱望，強い関心
passive	受身の，消極的な
passport	パスポート
past	過去の
past	過去の／過去
patience	辛抱強さ，忍耐
patient	我慢強い／患者
pause	話し［行動］を中断する／間（ま），小休止
pay	支払う
peace	平和
peaceful	平和な
peanut	ピーナッツ
peculiar	奇妙な
pen	ペン
pencil	鉛筆
people	人々
perceive	…を知覚する
percent	パーセント
perception	洞察（力），知覚
perform	…を行う，機能する
perhaps	多分
period	期間，時代
permanent	永久の，常設の
permit	…を許可する
person	人
personal	個人の
personal	個人的な，個人の
personality	人格，性格，（芸能界などの）有名人
perspective	見地，視座
persuade	説得する
pet	ペット
phenomenon	現象
philosopher	哲学者
philosophy	哲学
phone	電話
phone	電話／…に電話をかける
photo	写真
physical	身体の，物理的な
physics	物理学
piano	ピアノ
pick	選ぶ，摘む
picnic	ピクニック
picture	絵，写真
pie	パイ
piece	断片
pig	ブタ
pile	積み重ね，「山」
pioneer	開拓者，先駆者
place	場所
place	場所／…を置く
plain	簡素な，無地の／高原
plan	計画
plan	計画する
plane	飛行機
planet	惑星
plant	植物
plant	植物
plate	皿
play	遊ぶ，(スポーツを)をする，演奏する
play	劇
pleasant	楽しい，気持ちのよい
please	気に入る，喜ばせる
please	…を喜ばせる
pleased	喜んで
pleasure	楽しみ，喜び
plenty	たくさん
pocket	ポケット
poem	詩
point	点
poison	毒
police	警察
policeman	警官
policy	政策，方針
polite	礼儀正しい
political	政治の，政治的な
politician	政治家
politics	政治
pond	池
poor	貧乏な，かわいそうな，不十分な
pop	ポピュラー音楽
popular	人気のある
popular	人気のある，大衆の
popularity	人気
population	人口，国民
pork	ブタ肉
port	港
portion	部分
position	位置，地位
position	位置，立場，地位
positive	自信のある，肯定的な
possess	…を所有する
possession	所有，所有物
possible	可能な
possibly	ひょっとすると
post	郵便
pot	ポット
potato	じゃがいも
potential	潜在的な
pour	…を注ぐ
power	力
power	力，権力，大国
practical	実用的な，実際的な
practically	実質的に，ほとんど
practice	練習する
practice	練習，慣習，実行
praise	…をほめる
pray	祈る
precious	貴重な
precise	正確な
precisely	正確に
predict	…を予想する，…を予測する
prefer	…をより好む
preference	好み
prejudice	先入観，偏見
prepare	準備をする，…に準備をさせる
presence	存在
present	プレゼント
present	出席している，現在の
preserve	…を保存［保護］する
president	大統領
president	社長，大統領，学長
press	…を押す／マスコミ
pretend	…のふりをする
pretty	かなり
pretty	かなり
prevent	…を妨げる
previous	前の
price	価格
price	値段
primarily	主として
primary	最初の，主要な，最優先の
prime	主要な，最重要の
primitive	原始的な
prince	王子
principal	第一の，主要な／校長，学長
principle	原理・原則，主義
print	印刷する
private	個人的な，私的な
privilege	特権
prize	賞
probably	多分
probably	おそらく
problem	問題
problem	問題
proceed	進む
process	過程／…を加工処理する
produce	…を生みだす，…を生産する
product	製品，産物
production	生産，製造
profession	職業
professional	専門職の／専門職の人
profit	利益
profound	深い，大きな
program	番組
program	（実施）計画，プログラム
progress	進歩
project	計画，事業
promise	約束
promote	…を促進する
pronunciation	発音
proof	証拠
proper	適切な
properly	適切に
property	財産，所有地
proportion	比率，割合
propose	…を提案する
prospect	見通し，見込み
protect	…を守る
protest	抗議する／抗議
proud	自慢に思って
prove	…を証明する，…だと判明する
proverb	ことわざ
provide	…を［…に］与える
psychologist	心理学者
public	公共の／大衆
publish	…を出版する
punish	…を罰する
punishment	罰
purchase	…を購入する／購入
purpose	目的
pursue	…を追い求める
pursuit	追跡，追求
push	押す
put	置く
quality	質
quantity	量
queen	女王
question	質問
quick	速い
quickly	すばやく
quiet	静かな
quietly	静かに
quit	（…を）やめる
quite	まったく
quite	かなり，全く
quiz	クイズ
rabbit	ウサギ
race	競走，人種
racial	人種の
racket	ラケット
radio	ラジオ
railway	鉄道
rain	雨
rain	雨が降る
rainbow	虹
rainy	雨降りの
raise	(手などを)あげる，持ち上げる，育てる
raise	…を上げる
range	範囲／範囲が及ぶ
rank	階級，地位
rapidly	素早く
rare	まれな
rat	ネズミ
rate	率，割合
rational	理性的な
raw	生の
raw	生の，原料のままの
ray	光線
reach	着く，届く
reach	…に到着する，…に手が届く
react	反応する
reaction	反応　
read	読む
readily	すぐに
ready	用意できている
real	ほんとうの
reality	現実
realize	理解する，実現する
realize	…だとわかる，…を実現する
really	本当に
reason	理由，原因
reason	理由，理性
reasonable	理性のある，理にかなった
receive	受け取る
receive	…を受け取る
recent	最近の
recently	最近
recently	最近
recognition	その人［それ］だとわかること
recognize	…がそれ（その人）だとわかる
recommend	…を薦める
record	レコード
recover	回復する
red	赤い
reduce	…を減らす
refer	言及する，述べる
reference	言及，参照
reflect	…を反映する，熟考する
reflection	反映，反射
refuse	…を拒否する
regard	…を～と見なす
regardless	かかわらず，関係なく
region	地域，地方
regularly	規則的に，定期的に
reject	…を拒絶する
related	関係している，関連した
relation	関係
relationship	関係
relative	相対的［比較的］な
release	…を解き放つ
reliable	頼りになる
relief	安堵，軽減
relieve	…を和らげる，…から取り除く
religion	宗教
rely	頼る，信頼する
remain	…のままである，残る
remark	ことば，感想／…だと述べる
remarkable	目立った，顕著な
remember	思い出す，覚えている
remember	…を覚えている，…を思い出す
remind	…に思い出させる
remote	遠い
remove	…を取り除く
repair	…を修理する
replace	…に取って代わる
reply	返事
reply	返答する／返答
report	報告
reporter	レポーター
represent	…を表す，…を代表する
reputation	評判
request	…を依頼する／依頼
require	…を必要とする
requirement	要求される事柄，必要なもの
research	研究，調査
reserve	…を取っておく，…を予約する
resident	居住者
resist	…を拒む，…に抵抗する
resolve	…を解決する，決心する
respect	尊敬，尊重，点／…を尊敬する
respond	反応する，返答する
response	反応，返答
responsible	責任がある
rest	休息する
rest	休憩，その他／休憩する
restaurant	レストラン
restrict	…を制限する
result	結果
retain	…を保持する
retire	退職する，引退する
return	帰る
reveal	…を明らかにする
review	論評，批評／…を論評する，…を検討する
revolution	革命
reward	褒美，報償／…に褒美［報償］を与える
rice	ご飯
rich	金持ちの，豊かな
ride	乗る
right	右，権利
right	正しい，右に
right	正しい／権利
ring	指輪
rise	起き上がる，のぼる
rise	上がる，昇る
risk	危険，…を危険にさらす
ritual	儀式
river	川
road	道
rock	ロック
roll	転がる
roof	屋根
root	根
root	根，根源／…を根づかせる
rose	バラ
rough	ごつごつした，粗い，大雑把な
roughly	大雑把に
round	まわりに(を)
round	丸い
routine	いつもの／いつもの手順
row	こぐ
row	列／…をこぐ
rude	失礼な
ruin	…を台無しにする
rule	…を統治する／規則，習慣
run	走る
runner	ランナー
rural	田舎の
rush	殺到
rush	突進する，ダッシュする
sacrifice	犠牲／…を犠牲にする
sad	悲しい
safe	安全な
sail	(船を)走らせる
sailor	船員
salt	塩
same	同じ
satisfactory	満足のいく
satisfy	…を満足させる
Saturday	土曜日
save	救う，とっておく，節約する
save	…を省く，…を救う，…を貯蓄する
say	言う
scare	…を怯えさせる，…をびっくりさせる
scatter	…をまき散らす
scholar	学者
science	科学
science	科学
scientific	科学の
scientist	科学者
scream	金切り声を上げる
sea	海
search	…を捜す／探索，捜索
season	季節
seat	座席
seat	…を着席させる／席
second	2番目の
secret	秘密
secure	…を確保する，…を安全にする／ゆるぎない
security	安心，安全，治安
see	見る，わかる，調査する
seed	種子
seek	…を求める
seem	～のように思われる
seem	…であるようだ
seldom	めったに…しない
select	選ぶ
select	…を選び出す
self	自己，自我
sell	売る
send	送る
senior	年上の，上級の
senior	ポストが上の，上級の／年上の人
sense	感じ
sense	感覚，意味
sensible	分別［判断力］がある
sensitive	敏感な，神経質な
sentence	文
separate	分離した／…を切り離す
September	９月
serious	真剣な，深刻な
servant	使用人，お手伝い
serve	…の役に立つ，…に仕える
set	置く
settle	…を決着させる，落ち着く
seven	7
seventeen	17
seventeenth	１７番目の
seventh	7番目の
seventy	70
severe	厳しい
shade	陰
shade	日陰
shake	震える
shame	恥，不名誉，残念なこと
shape	形／…を形作る
share	分け合う
share	…を分かち合う
she	彼女は
sheep	羊
shelter	避難，避難場所
shift	変化／…を変える
shine	光る，輝く
ship	船
shirt	シャツ
shock	ショック
shoe	靴
shoot	撃つ
shop	店
shop	買い物をする
shore	岸，海岸
short	短い，背が低い
shortage	不足
shoulder	肩
shout	叫ぶ
show	ショー
show	見せる
sick	病気で(の)
side	側面
side	側面，側
sight	見ること，視力
sign	合図，標識
sign	兆候／…に署名をする
signal	信号
significance	重要性，意義
significant	重要な
silent	静かな
silk	絹
silly	馬鹿な
silver	銀
similar	よく似た
similarity	類似（点）
simple	簡単な，質素な
simply	単に
sing	歌う
single	一つの，一人の，独身の
sink	沈む
sit	座る
site	場所，用地
situation	状況，情勢
six	6
sixteen	16
sixteenth	１６番目の
sixth	6番目の
sixty	60
skate	スケートをする
ski	スキーをする
skill	技能
skin	皮膚，皮膜
skirt	スカート
sky	空
sleep	眠る
sleepy	眠い
slight	かすかな
slightly	わずかに
slow	遅い
slowly	ゆっくりと
small	小さな
smart	頭の良い
smell	においがする
smell	…な臭いがする，…の臭いをかぐ
smile	ほお笑み
smoke	煙
snake	蛇
snow	雪
snowy	雪の降る
so	そんなに
soccer	サッカー
social	社会の，社交の
socially	社会的に
society	社会
sofa	ソファー
soil	土
soil	土，土壌
soldier	兵士
solid	固い／固体
solution	解決（法）
solve	解決する
solve	…を解く
some	いくつかの
somehow	どうにか
someone	だれか
something	何か
sometimes	時々
somewhat	いくぶん
song	歌
soon	すぐに
sorry	残念な
sort	種類
sort	種類
sound	音
sound	(～のように)聞こえる
sound	…に聞こえる／音
soup	スープ
south	南
space	宇宙
spare	予備の／＜時間・手間＞をさく
speak	話す
special	特別の
special	特別な
specialist	専門家，専門医
specialize	専門にする，専攻する
species	（動植物の）種
specific	具体的な，特定の
speech	演説
speech	話，スピーチ，演説
spelling	綴り
spend	費やす，過ごす
spend	…を費やす
spiritual	精神の，精神的な
spoil	…を台無しにする
sport	スポーツ
spread	広がる，…を広げる
spring	春
square	正方形
stage	段階，舞台
stamp	切手
stand	立つ
standard	標準，基準
star	星，スター
stare	…をじっと見つめる
start	出発する，～を始める
state	状態，国家，州
statement	話，陳述，声明
statistics	統計
statue	像
status	社会的地位
stay	滞在する
stay	滞在
stay	…のままである，とどまる
steadily	着実に
steady	着実な
steal	…をこっそり盗む
steam	蒸気
step	足元，階段
step	措置，歩み
stick	くっつく，固執する／棒きれ
still	まだ
stimulate	…を刺激する
stock	株，在庫／…を在庫に持つ
stone	石
stop	止める，止まる
stop	停留所
story	話
straight	まっすぐに
strange	奇妙な
strange	奇妙な，見知らぬ
stranger	見知らぬ人
stranger	見知らぬ人，（ある場所に）初めて来た人
street	通り
strength	力，強さ
strengthen	…を強化する
stress	強調，重圧／…を強調する
stretch	広がる／広がり
strict	厳しい，厳密な
strike	打つ
strike	…を叩く，…に～という印象を与える
strip	細長い一片［地域］／…をはぎ取る
strong	強い，じょうぶな
structure	構造
struggle	もがき苦しむ
study	勉強する
stuff	モノ
stupid	馬鹿な
subject	科目，題目
subject	話題，主題
substance	物質
substitute	…を代わりに使う／代わり
subtle	微妙な
suburb	郊外
succeed	成功する
success	成功
success	成功，成功したもの［人］
such	そのような
sudden	突然の
suddenly	突然
suffer	苦しむ，…を患う
sufficient	十分な
sugar	砂糖
suggest	…を提案する，…を示唆する
suit	スーツ
suit	…に適合する／訴訟
suitable	適した
sum	金額，合計
summer	夏
sun	太陽
Sunday	日曜日
sunset	日没
superior	より優れた
supper	夕食
supply	供給／…に供給する
support	…を支持［支援］する／支持，支援
suppose	…だと思う，…だと仮定する
suppress	…を抑える
sure	確信して
sure	確信して，確実な
surely	確かに
surely	確かに
surface	表面
surprise	…を驚かせる／驚き
surround	…を取り囲む
survey	調査
survival	生存
survive	（…を切り抜け）生き残る
suspect	…を疑う，…ではないかと思う／容疑者
swallow	…を飲み込む
sweep	…を掃く，…を掃くように動かす
swim	泳ぐ
symbol	象徴
system	体制，体系，組織
table	テーブル
take	(時間が)かかる，連れて行く，持っていく，取る
tale	お話
talent	才能
talk	話す
tall	背の高い
tape	テープ
task	仕事，作業
taste	味／…な味がする
taxi	タクシー
tea	お茶
teach	教える
team	チーム
tear	涙
tear	…を引き裂く／涙
technical	技術上の，専門的な
technology	テクノロジー，科学技術
telescope	望遠鏡
tell	教える，語る
temperature	温度，体温
ten	10
tend	…する傾向がある
tennis	テニス
tension	緊張
tent	テント
tenth	10番目の
term	期間，学期，用語，条件，間柄
terrible	ひどい，不快な
territory	領土
test	試験
test	試みる
text	本文，書かれたもの
textbook	教科書
than	よりも
thank	感謝する
that	あれは
that	あの
theater	劇場
their	彼(女)らの
theirs	彼(女)らのもの
them	彼(女)らを(に)
theme	テーマ
themselves	彼(女)ら自身
then	それから，そのとき，それでは
theory	理論
there	そこに
therefore	それゆえ
these	これらは
these	これらの
they	それらは，彼(女)らは
thick	厚い
thing	こと・物
think	考える
third	3番目の
thirteen	13
thirteenth	１３番目の
thirtieth	３０番目の
thirty	30
this	この
this	これは
those	あれらの
those	あれらは
though	だけれども
thought	考え
thought	考えること，考え
thousand	千
threat	脅威
threaten	…を脅かす
three	3
throw	投げる
Thursday	木曜日
ticket	切符
tide	潮，風潮
tie	ネクタイ
time	時，～回
tiny	小さな
tiny	ごく小さい
tip	先，先端
tired	疲れて
toast	トースト
today	今日，現在
together	一緒に
tomorrow	明日
tone	音，音色，（声・ことばの）調子，
tongue	言葉，舌
tonight	今夜(は)
too	～もまた，～すぎる
tooth	歯
tooth	歯
top	頂上
totally	完全に
touch	触れる，感動する
tough	頑強な
tour	小旅行
toward	…に向かって
tower	塔
toy	おもちゃ
trace	…の跡［起源］を辿る／跡，痕跡
trade	貿易
trade	貿易，…を交換する
tradition	伝統
traditional	伝統的な
traditionally	伝統的に
traffic	交通，往来／交通の
traffic jam	交通渋滞
tragedy	悲劇
trail	通った跡，でこぼこ道
train	列車
train	訓練する
training	トレイニング
trait	特性，特徴
transfer	…を移す
transform	…を変える
translate	…を翻訳する
transport	…を輸送する／輸送
transportation	輸送
trap	わな／…をわなにかける
travel	旅行
treasure	宝物
treasure	宝，財宝
treat	…を扱う
treatment	扱い，処置，治療
tree	木
tremendous	非常に大きな
trial	裁判，試み
tribe	部族
trick	…をだます／手品，こつ
trip	旅行
tropical	熱帯（地方）の
trust	信頼，信用／…を信頼［信用］する
truth	真実
try	試す
Tuesday	火曜日
turn	曲がる，回る，変化する
TV	テレビ
twelfth	１２番目の
twelve	12
twentieth	２０番目の
twenty	20
twice	２回
two	2
type	型
typical	典型的な
ultimate	究極の
umbrella	かさ
uncomfortable	心地の悪い
undergo	…を経験する
understand	理解する
undoubtedly	疑いなく
unemployment	失業
unexpected	予期せぬ
unfortunately	残念なことに
unhappy	不幸な
union	統合
unique	他に類のない，特別な
universal	普遍的な，万国［万人］共通の
universe	宇宙
universe	宇宙
university	大学
unknown	未知の，無名の
unless	…でない限り（原則として）
unlike	…とは違って
unlikely	可能性が低い
unpleasant	不愉快な
unusual	めずらしい，普通でない
up	上へ
upset	気持ちが動揺した／…の心をかき乱す
urban	都会の，都市の
urge	…を（強く）促す［要請する］／願望
us	私たちを(に)
use	使う
use	使用
useful	役に立つ
useful	役に立つ
useless	役に立たない
usual	通常の
usually	ふつう
vacation	休暇
valley	谷
valuable	貴重な
value	価値／…を重んじる
variety	多様
various	さまざまな
vary	さまざまである
vast	非常に大きな
vegetable	野菜
vehicle	乗り物，伝達手段
verbal	ことばの，口頭での
version	…版，別形式
very	非常に
victim	犠牲者
video	ビデオ
view	眺め，見方／…を見る，…を～と見なす
violence	暴力
virtually	実質的に
virtue	徳，美徳，長所
virus	ウイルス
visible	目に見える
vision	未来像，ビジョン
visit	訪問する
visitor	訪問者
visual	視覚の，視覚的な
vital	極めて重要な，必要不可欠な
vocabulary	語い
voice	声
volleyball	バレーボール
volunteer	ボランティア，志願兵
vote	投票する／投票
voyage	航海
wage	賃金
wait	待つ
wake	目が覚める
walk	散歩
walk	歩く
wander	ぶらつく，放浪する
want	欲しい
war	戦争
war	戦争
warm	温暖な
warn	…に警告する
wash	洗う
waste	浪費
waste	…を浪費する／浪費，廃棄物
watch	腕時計
watch	見る
water	水
wave	波
way	道，方法
we	私たちは
weak	弱い
wealth	富，財産
wealthy	裕福な
weapon	武器
wear	着る
wear	…を身につけている
weather	天気
weather	気候，天気
Wednesday	水曜日
week	週
weekly	週刊
weigh	…の重さがある
weight	重さ，体重
welcome	ようこそ
welcome	歓迎される／…を歓迎する
well	よく，じょうずに
well	健康な
well-known	よく知られた
west	西
Westerner	西洋人，西部に住む人
wet	濡れている
what	何
when	～するとき
where	どこに
whereas	…である一方で
wherever	…する所はどこでも
which	どちら
while	～する間
while	…である一方で，…している間に
whisper	ささやく
white	白い
who	だれ
whole	すべての
whole	…の全て，全体の
whose	だれの(もの)
why	なぜ
wide	幅が広い
widely	広範囲に
widespread	広範囲に渡る
wife	妻
wild	荒々しい，野生の
willing	いとわない，やぶさかでない
win	勝つ
win	勝つ，…を勝ち取る
wind	風
wine	ワイン
winter	冬
wisdom	知恵
wish	望む
witness	目撃者，証人／…を目撃する
wonder	不思議に思う
wonder	…かなと思う／驚き
wonderful	すばらしい
wood	木材
word	言葉
work	仕事，作品
work	働く
worry	悩ませる
worry	…を心配させる／心配
worth	…の価値がある
write	書く，手紙を書く
wrong	間違った，ぐあいが悪い
wrong	間違った
year	年
yell	大声を上げる
yellow	黄色の
yen	円
yes	はい
yesterday	昨日
yet	まだ(～でない)
you	あなたに(を)，あなたがたを
you	あなたは，あなたがたは
young	若い
your	あなたの，あなたがたの
yours	あなたのもの，あなたがたのもの
yourself	あなた自身
youth	若さ
youth	若さ，青年期，青少年
zone	地帯
zoo	動物園
FALSE	誤った，偽りの
