
I	私は(が)
my	私の
or	それとも
we	私たちは
do	する
it	それは
he	彼は
us	私たちを(に)
up	上へ
TV	テレビ
so	そんなに
go	行く
it	それを(に)
no	いいえ
if	もし
me	私を
beg	…を乞う
say	言う
too	～もまた，～すぎる
sea	海
eat	食べる
see	見る，わかる，調査する
pig	ブタ
his	彼の
due	行われる［到着する］予定である
cow	雌牛
pet	ペット
mom	おかあちゃん
zoo	動物園
him	彼を(に)
add	…を付け加える
mix	混ぜる
pen	ペン
set	置く
pay	支払う
she	彼女は
dog	犬
eye	目
pal	友だち
sit	座る
pop	ポピュラー音楽
six	6
pot	ポット
ski	スキーをする
own	自分の
sky	空
our	私たちの
May	５月
put	置く
fan	ファン
yet	まだ(～でない)
use	使用
old	年をとった，古い
use	使う
oil	油
far	遠くに，はるかに
age	年齢，時代
yen	円
off	離れて
fat	太った
ago	前
her	彼女を（に）
die	死ぬ
her	彼女の
hot	暑い
arm	腕
aim	ねらいをつける／目的
fat	太った／脂肪
not	～でない
map	地図
raw	生の
few	(aをつけ)少数の
raw	生の，原料のままの
fit	…に適合する／適した
all	すべての
fix	…を固定する，…を修理する
joy	喜び
key	鍵
joy	喜び
art	美術，芸術
era	時代
low	低い
nod	うなずく
fly	飛行機で行く，飛ぶ
new	新しい
kid	子供／（…を）からかう
row	こぐ
lot	たくさん
row	列／…をこぐ
ask	たずねる，頼む
run	走る
ill	病気の
war	戦争
two	2
dad	お父ちゃん
sum	金額，合計
sad	悲しい
sun	太陽
cup	カップ
fox	キツネ
you	あなたは，あなたがたは
try	試す
ink	インク
cat	猫
pie	パイ
lip	くちびる
win	勝つ，…を勝ち取る
car	自動車
win	勝つ
tea	お茶
why	なぜ
cap	帽子
ice	氷
hat	帽子
own	自身の／…を所有している
can	カン
end	終わる
ten	10
one	1
buy	買う
jam	ジャム，混雑
but	しかし
odd	変な，奇数の／（（oddsで））可能性
bus	バス
die	死ぬ
fun	楽しみ
air	空気
fur	毛皮
job	仕事
lie	横たわる，嘘をつく
all	まったく
box	箱
ray	光線
bow	お辞儀をする／お辞儀
you	あなたに(を)，あなたがたを
toy	おもちゃ
hit	…を叩く
lie	横たわる，～にある
war	戦争
gas	ガス
cut	切る
lie	嘘
cry	泣く
leg	脚
ear	耳
top	頂上
add	加える
bit	少し
yes	はい
gym	体育館
owe	…に金を借りている
gun	鉄砲
its	それの
get	得る，着く，乗る
now	今
get	…になる，…を手に入れる
rat	ネズミ
big	大きい
way	道，方法
God	神
net	網
god	神
hit	打つ
tie	ネクタイ
his	彼のもの
bad	悪い
egg	卵
bed	ベッド
wet	濡れている
bag	カバン
aid	援助／…を助ける
tip	先，先端
red	赤い
lay	…を横たえる
and	～と
bat	バット
bar	棒，横木
law	法律
law	法律，法則
dry	乾く
day	日
all	みんな
how	どのくらい
who	だれ
form	形態／…を形成する
east	東
fall	秋
best	一番良い
skin	皮膚，皮膜
tone	音，音色，（声・ことばの）調子，
fair	公平な，かなりの
gray	灰色
high	高い
gram	グラム
fail	失敗する
bath	風呂
fail	失敗する
band	バンド
meal	食事
bear	…を我慢する
vary	さまざまである
ball	ボール
site	場所，用地
tiny	ごく小さい
vast	非常に大きな
land	陸地，土地
sink	沈む
beer	ビール
sing	歌う
gold	金
fact	事実
lake	湖
silk	絹
back	裏の，後ろの
sign	兆候／…に署名をする
bell	ベル
sign	合図，標識
goal	得点，ゴール
fact	事実
your	あなたの，あなたがたの
side	側面，側
this	これは
side	側面
lazy	怠け者の
sick	病気で(の)
give	与える，(会などを)開く
show	見せる
lady	婦人
show	ショー
away	離れて
meal	食事
they	それらは，彼(女)らは
face	…に直面する
lack	不足，欠落／…がない
face	顔
hair	髪
shop	買い物をする
leaf	葉
shop	店
left	左
very	非常に
lend	貸す
shoe	靴
blow	吹く
mean	意味する
blue	青い
mean	…を意味する，…を意図する
body	身体
ship	船
bomb	爆弾
meat	肉
gaze	じっと見つめる
meet	会う
tour	小旅行
melt	溶ける，…を溶かす
both	両方
able	できる，有能な
hand	手渡す
menu	メニュー
hang	…をつるす，…を絞首刑にする
mile	マイル
them	彼(女)らを(に)
milk	牛乳
know	知っている
mind	精神
hard	いっしょうけんめい
mind	アタマ，思考／…を嫌がる
that	あれは
mine	私のもの
fund	資金，基金
miss	間違う，いなくてさみしく思う
harm	害／…を害する
miss	…が（い）ないのを寂しく思う，…に乗り損なう，ミスする
full	いっぱいの，満腹である
view	眺め，見方／…を見る，…を～と見なす
like	好む
cook	料理する
test	試験
cool	涼しい
bury	…を埋める
mitt	ミット
term	期間，学期，用語，条件，間柄
cope	対処する
king	王様
copy	模写する
trap	わな／…をわなにかける
copy	（本・雑誌などの）一冊／…をまねる
tent	テント
hill	丘
calm	落ちついた
June	６月
tend	…する傾向がある
cost	…を（費用として）必要とさせる／費用
kind	種類
mood	気分
tell	教える，語る
send	送る
tear	涙
sell	売る
hate	…をひどく嫌う
self	自己，自我
line	行，列
seem	…であるようだ
taxi	タクシー
seem	～のように思われる
task	仕事，作業
moon	月
card	カード
most	ほとんど
care	世話，管理
hire	…を雇う
tape	テープ
most	大半／最も…
talk	話す
move	動く，感動させる
head	頭，先頭
seek	…を求める
case	場合，事例
seed	種子
take	(時間が)かかる，連れて行く，持っていく，取る
vote	投票する／投票
list	リスト
crew	乗組員，一団
load	積み荷／…を積む
much	ずっと，たいへん
cave	ほら穴
seat	…を着席させる／席
swim	泳ぐ
seat	座席
cent	セント
wage	賃金
sure	確信して，確実な
much	多量の
yell	大声を上げる
wait	待つ
suit	…に適合する／訴訟
crop	収穫物
four	4
wake	目が覚める
long	長く
myth	神話
such	そのような
name	名前
type	型
name	名づける
lose	失う，負ける
jump	跳ぶ
stop	止める，止まる
save	…を省く，…を救う，…を貯蓄する
loss	失うこと，損失
save	救う，とっておく，節約する
Asia	アジア
same	同じ
foot	足
July	７月
step	措置，歩み
cure	…を治療する
fool	馬鹿
salt	塩
stay	…のままである，とどまる
sail	(船を)走らせる
fond	好きで
safe	安全な
love	愛する
walk	散歩
year	年
rush	突進する，ダッシュする
flow	流れる／流れ
rush	殺到
luck	運，幸運
neck	首
keep	保つ，～を(持ち)続ける
walk	歩く
five	5
cute	可愛い
fish	魚
want	欲しい
fire	…を首にする
exam	試験
lung	肺
warm	温暖な
fine	うまく
rule	…を統治する／規則，習慣
find	見つける，～とわかる
need	必要な
main	主な
ruin	…を台無しにする
coat	コート
dare	思い切って…する，生意気にも…する
coin	硬貨
dark	暗い，黒い
fill	いっぱいにする
date	日付
many	多くの
date	デートする
army	陸軍
warn	…に警告する
soup	スープ
dear	親愛なる
feel	感じる
nest	巣
mark	しるし，（試験の）点数／…の印となる
rude	失礼な
sort	種類
debt	借金，負債
soon	すぐに
wash	洗う
some	いくつかの
hold	握る，開催する，差し出す
arms	武器，兵器
evil	邪悪な，悪の
soil	土，土壌
hold	…を（一時的に）持っている
sofa	ソファー
hole	穴
fast	速く
rose	バラ
fast	速い
root	根，根源／…を根づかせる
farm	農場
deep	深い
hers	彼女のもの
root	根
keen	切望した，熱意のある
roof	屋根
fall	落ちる
roll	転がる
last	最後
rock	ロック
grow	成長する，になる，増加する，育てる，栽培する
road	道
bear	クマ
news	ニュース
bake	オーブンで焼く
next	次の，隣の
beef	牛肉
risk	危険，…を危険にさらす
time	時，～回
rise	上がる，昇る
baby	赤ん坊
rise	起き上がる，のぼる
belt	ベルト
ring	指輪
this	この
nice	すばらしい
gift	贈り物
ever	今まで
bind	…を縛りつける
nine	9
lead	…の先頭に立つ，つながる
ride	乗る
leap	跳ぶ
deny	…を否定する
gene	遺伝子
rich	金持ちの，豊かな
boat	ボート
rice	ご飯
book	本
rest	休憩，その他／休憩する
then	それから，そのとき，それでは
rest	休息する
bowl	鉢
even	～さえ
gain	…を得る／獲得
holy	神聖な
that	あの
rely	頼る，信頼する
than	よりも
home	家を(へ)
full	いっぱいの
also	もまた
fuel	燃料
real	ほんとうの
busy	忙しい
desk	机
cake	ケーキ
none	何も(だれも)～ない
calm	穏やかな，落ち着いた
read	読む
tree	木
noon	正午
line	線，列
wave	波
have	持っている，食べる
nose	鼻
trip	旅行
home	故郷，家
care	気にかける／注意，関心
join	参加する
tale	お話
hope	希望
cash	現金
rate	率，割合
live	住む，生きる
hope	望む
free	自由な，ひまな
rare	まれな
turn	曲がる，回る，変化する
rank	階級，地位
kill	殺す
host	主人
long	長い
note	メモ／…に注目［注意］する
lord	封建君主，…卿，（（大文字で））神
weak	弱い
stop	停留所
wear	着る
lost	道に迷った。
diet	（日常の）食事，ダイエット
love	愛，愛する人
hour	時間
food	食べ物
wear	…を身につけている
stay	滞在する
week	週
hear	聞く
rain	雨が降る
flat	平らな
rain	雨
urge	…を（強く）促す［要請する］／願望
huge	巨大な
fire	火
race	競走，人種
fine	すばらしい，元気な，晴れた
quiz	クイズ
club	クラブ
well	よく，じょうずに
cold	冷たい，寒い
once	かつて，１度
help	助ける
well	健康な
come	来る
quit	（…を）やめる
sort	種類
open	開ける
song	歌
open	開いている
area	地域，面積
west	西
area	地域
what	何
mass	塊，集団，大衆
push	押す
math	数学
when	～するとき
just	ちょうど，ただ単に
item	項目
band	（音楽の）バンド，一団
ours	私たちのもの
tiny	小さな
hunt	狩りをする
tide	潮，風潮
hunt	捜し求める
bend	…を曲げる
hurt	傷つける
bill	請求書，紙幣，法案
page	ページ
bite	…を噛む，…を刺す
pain	痛み
blow	（…を）吹く／打撃
pain	痛み
hall	玄関の広間，ろうか
dish	皿，料理
game	試合
pray	祈る
life	生活，人生，生命
else	そのほかに
test	試みる
pair	一組
frog	カエル
pour	…を注ぐ
camp	キャンプ
hurt	…を傷つける
team	チーム
post	郵便
care	気にする
port	港
case	場合，容器
pork	ブタ肉
free	束縛のない，無料の，暇な
zone	地帯
sure	確信して
poor	貧乏な，かわいそうな，不十分な
look	見る，～に見える
pond	池
lose	…を失う，負ける
idea	考え
step	足元，階段
poem	詩
fold	…を折りたたむ
play	劇
star	星，スター
idea	考え，思いつき
mail	郵便
play	遊ぶ，(スポーツを)をする，演奏する
film	映画
iron	鉄
mark	印
doll	人形
fear	…を恐れる／恐れ
pale	青ざめた
soil	土
part	部分
here	ここに
pass	過ぎる，合格する，手渡す
last	この前の，最後の
door	ドア
good	良い
past	過去の
glad	うれしい
down	下に
half	半分
past	過去の／過去
hand	手
draw	描く，引く
text	本文，書かれたもの
draw	…を引きつける
call	電話をかける
wide	幅が広い
lion	ライオン
wife	妻
kind	親切な
plan	計画する
suit	スーツ
wild	荒々しい，野生の
loud	(声の)大きい
wind	風
luck	運
plan	計画
mail	郵便／…を投函する
drop	落とす
feed	…に食べ物を与える，…を養う
drug	麻薬，薬
snow	雪
wine	ワイン
beat	…をうち負かす
duck	あひる
bird	鳥
wish	望む
life	生活，生命，人生
dull	面白みのない，鈍い
tear	…を引き裂く／涙
dumb	口のきけない
cell	細胞
pick	選ぶ，摘む
stay	滞在
wood	木材
make	作る，～を～にする
each	おのおのの
slow	遅い
word	言葉
boil	ゆでる，煮る
work	仕事，作品
tall	背の高い
firm	しっかりした，堅い／会社
easy	やさしい，気楽に
earn	…を稼ぐ
work	働く
pile	積み重ね，「山」
fate	運命
fork	フォーク
kiss	キスをする
goal	目標，目的
imply	…をほのめかす
state	状態，国家，州
write	書く，手紙を書く
civil	公民の，（軍事に対し）民間の
place	場所／…を置く
steal	…をこっそり盗む
early	早く
steam	蒸気
early	早い
stick	くっつく，固執する／棒きれ
piece	断片
China	中国
plain	簡素な，無地の／高原
child	子供
photo	写真
force	力／…を［に］強制する
phone	電話
still	まだ
drink	飲む
stock	株，在庫／…を在庫に持つ
eight	8
stone	石
dream	夢
charm	魅力／…を魅了する
plane	飛行機
story	話
plant	植物
strip	細長い一片［地域］／…をはぎ取る
party	パーティー
study	勉強する
paper	新聞，書類，レポート，論文
stuff	モノ
pants	ズボン
forth	4番目の
point	点
sugar	砂糖
power	力，権力，大国
forty	40
press	…を押す／マスコミ
chalk	チョーク
price	値段
found	…を設立する
prime	主要な，最重要の
chair	いす
prize	賞
chain	くさり
proof	証拠
logic	論理，理屈
other	ほかの
local	地元の
order	命令，秩序／…に命じる，…を注文する
sweep	…を掃く，…を掃くように動かす
enemy	敵
cease	…をやめる，終わる
orbit	軌道
cause	原因／…の原因となる，…に～させる
quick	速い
table	テーブル
enjoy	楽しむ
catch	…に乗るのに間に合う，…が～しているのを見つける
quite	まったく
catch	捕まえる，(列車に)間に合う
enter	入る
fresh	新鮮な
radio	ラジオ
carry	運ぶ
offer	…を申し出る／申し出
taste	味／…な味がする
raise	(手などを)あげる，持ち上げる，育てる
teach	教える
raise	…を上げる
candy	キャンディー
range	範囲／範囲が及ぶ
tenth	10番目の
diary	日記
front	前
reach	着く，届く
limit	限度，制限／…を制限する
north	北
fruit	果物
react	反応する
burst	破裂する，…を破裂させる
noisy	騒がしい
build	建てる
refer	言及する，述べる
brush	筆
ninth	9番目の
brown	茶色の
right	右，権利
fully	十分に，完全に
night	夜
bring	持って来る
every	毎～
light	薄い
delay	…を遅らせる
thank	感謝する
rough	ごつごつした，粗い，大雑把な
light	光，明かり，信号
round	まわりに(を)
brief	短い
death	死
funny	おかしな
exact	正確な
their	彼(女)らの
daily	毎日の
break	壊れる，破る
crowd	群衆，人混み
bread	パン
cross	…を横切る／不機嫌な
brave	勇敢な
music	音楽
brain	頭脳
crime	犯罪
theme	テーマ
mouth	口
there	そこに
crash	衝突／衝突する
bored	退屈した
cover	おおう
these	これらは
month	月
blood	血
money	お金
level	レベル，水準，程度
model	模型
blood	血
serve	…の役に立つ，…に仕える
lemon	レモン
shade	陰
legal	法律の，合法な
shade	日陰
block	…を妨げる
shame	恥，不名誉，残念なこと
blink	まばたきをする／まばたき
share	分け合う
leave	去る，残す，置いて行く
merry	陽気な
learn	学ぶ，覚える
sheep	羊
blind	目の見えない
shift	変化／…を変える
black	黒い
extra	余分の
these	これらの
shirt	シャツ
birth	誕生
shoot	撃つ
thick	厚い
short	短い，背が低い
thing	こと・物
sight	見ること，視力
think	考える
sixth	6番目の
worth	…の価値がある
sixty	60
glass	コップ，ガラス
maybe	たぶん，五分五分で
third	3番目の
maybe	おそらく
globe	地球
faith	信頼，信仰
glove	グローブ
sleep	眠る
bench	ベンチ
smart	頭の良い
those	あれらの
smell	においがする
those	あれらは
smile	ほお笑み
three	3
smoke	煙
throw	投げる
snowy	雪の降る
begin	始まる(める)
solve	解決する
FALSE	誤った，偽りの
fault	欠点，過失，せい
goods	商品
marry	…と結婚する
tired	疲れて
marry	結婚する
beach	砂浜
sound	(～のように)聞こえる
grade	評点，等級
color	色
toast	トースト
fence	塀
laugh	笑う
space	宇宙
today	今日，現在
spare	予備の／＜時間・手間＞をさく
later	後に，…後
fifth	5番目の
grand	壮大な
fight	戦う
later	後で
spend	費やす，過ごす
basis	土台，基礎
final	最後の
grant	給付金／…を与える
cloud	雲
grape	ブドウ
cloth	布
grasp	…をつかむ，…を理解する
close	近い，親密な
grass	草
close	閉じる
grave	墓／深刻な
cling	しがみつく，固執する
basic	基本的な，基礎的な
first	1番目の
great	すばらしい，広大な
lucky	好運な
green	緑の
stand	立つ
greet	…にあいさつをする
flame	炎
based	基づいている
clean	きれいな
large	大きい，広い
float	浮かぶ
group	グループ
class	階級，等級，授業，学級
tooth	歯
focus	焦点／…を集中する
badly	ひどく，悪く
earth	地球，大地
tooth	歯
eager	強く望んでいる
guard	…の警護［監視］をする／警護者，監視者
piano	ピアノ
guess	…だと思う，…を推測する／当てずっぽう
drive	運転する
guest	客
peace	平和
guide	案内人
doubt	疑い／…を疑う
guide	案内人，案内書／…を案内する
plant	植物
awful	ひどい
plate	皿
aware	気づいている
paint	描く，(～に)ペンキを塗る
awake	目を覚ましている
owner	所有者
awake	目が覚める
empty	何も入っていない，空の
habit	習慣
prove	…を証明する，…だと判明する
habit	（個人の）習慣，癖
order	注文する
avoid	…を避ける
quiet	静かな
touch	触れる，感動する
quite	かなり，全く
tough	頑強な
often	しばしば
tower	塔
ocean	大洋
trace	…の跡［起源］を辿る／跡，痕跡
equal	等しい／…に等しい
labor	労働
reach	…に到着する，…に手が届く
trade	貿易
ready	用意できている
trade	貿易，…を交換する
reply	返事
knock	ノックする
event	出来事，行事
knife	ナイフ
right	正しい／権利
happy	幸福な，楽しい
never	１度も～ない
trail	通った跡，でこぼこ道
nerve	神経
train	列車
rural	田舎の
train	訓練する
cross	横切る
trait	特性，特徴
crazy	気の狂った
treat	…を扱う
cover	…を覆う，…（の範囲を）カバーする
trial	裁判，試み
exist	存在する
tribe	部族
sense	感覚，意味
trick	…をだます／手品，こつ
minor	小さな，重要度の低い
yours	あなたのもの，あなたがたのもの
shape	形／…を形作る
trust	信頼，信用／…を信頼［信用］する
share	…を分かち合う
truth	真実
medal	メダル
twice	２回
shock	ショック
union	統合
shout	叫ぶ
upset	気持ちが動揺した／…の心をかき乱す
young	若い
heart	心
skill	技能
arrow	矢
skirt	スカート
heavy	重い，大量の
match	試合／…と調和する
urban	都会の，都市の
match	試合
hello	こんにちわ
solid	固い／固体
wrong	間違った
favor	親切な行為
arise	起こる，生じる
sound	音
argue	（感情的に）論じる，…だと主張する
March	３月
April	４月
field	分野，領域，野原，畑
usual	通常の
fifty	50
apply	…を適用する，当てはまる
spend	…を費やす
value	価値／…を重んじる
sport	スポーツ
apple	りんご
close	接近した
video	ビデオ
lunch	昼食
apart	離れて
stamp	切手
virus	ウイルス
clean	掃除する
visit	訪問する
start	出発する，～を始める
vital	極めて重要な，必要不可欠な
claim	…が自分のものだと主張する
voice	声
dwell	住む
annoy	…をいらだたせる
dress	着る
angry	怒って
party	政党，当事者
anger	怒り
power	力
juice	ジュース
print	印刷する
amuse	…を楽しませる
enemy	敵
waste	浪費
dirty	汚れた
hobby	趣味
rainy	雨降りの
waste	…を浪費する／浪費，廃棄物
equip	…に備え付ける［身につけさせる］
watch	腕時計
noise	物音
watch	見る
right	正しい，右に
judge	…を判断する／審判員，裁判官
round	丸い
water	水
crowd	群衆
alter	…を変える
mouse	はつかねずみ
aloud	声に出して
sense	感じ
alone	ひとりきりで
shake	震える
allow	…を許可する，…が～するのを許す
melon	メロン
alive	生きている
shore	岸，海岸
alike	よく似た
skate	スケートをする
honey	蜂蜜
small	小さな
honor	名誉，敬意
snake	蛇
album	アルバム
sorry	残念な
alarm	懸念／…に懸念を抱かせる
south	南
horse	馬
major	主な，大きな／専攻する
wrong	間違った，ぐあいが悪い
stage	段階，舞台
ahead	前方に
climb	登る
agree	同意する，賛成する
stare	…をじっと見つめる
jewel	宝石
place	場所
agent	代理人，代理店
pause	話し［行動］を中断する／間（ま），小休止
jeans	ジーンズ
price	価格
again	再び
queen	女王
weigh	…の重さがある
novel	小説／新奇な
human	人間の
reply	返答する／返答
human	人間の／人間
dance	踊る
after	～の後で
count	重要である，数える
where	どこに
meter	メートル
youth	若さ
silly	馬鹿な
youth	若さ，青年期，青少年
smell	…な臭いがする，…の臭いをかぐ
which	どちら
sound	…に聞こえる／音
while	～する間
spoil	…を台無しにする
hurry	急ぐ
clerk	事務員
while	…である一方で，…している間に
phone	電話／…に電話をかける
white	白い
proud	自慢に思って
issue	問題，（雑誌などの）号／…を出す
error	ミス，間違い
whole	すべての
scare	…を怯えさせる，…をびっくりさせる
adopt	…を自分のものにする
shine	光る，輝く
admit	…を認める
solve	…を解く
whole	…の全て，全体の
clock	置き時計
ideal	理想／理想の
paper	紙，レポート
whose	だれの(もの)
river	川
fairy	妖精
worry	…を心配させる／心配
worry	悩ませる
adapt	…を適合［適応］させる
inner	内部の
speak	話す
seven	7
enter	…に入る
class	学級，授業
junior	ポストが下の，下級の／年下の人
cloudy	曇った
orange	オレンジ
coffee	コーヒー
abroad	外国で，外国へ
finger	指
absorb	…を吸収する，…を没頭させる
speech	話，スピーチ，演説
accept	…を受け入れる
speech	演説
access	アクセス，使用［閲覧］する機会［権利］
colony	植民地
yellow	黄色の
figure	数字，姿，人物
accuse	…を非難［告発］する
commit	＜罪など＞を犯す
action	行動
common	共通の
wonder	不思議に思う
mammal	哺乳動物
wisdom	知恵
manage	何とかうまくやる，管理を行う
income	所得
common	一般的な，共通の
widely	広範囲に
manner	やり方，方法
indeed	確かに
social	社会の，社交の
admire	…をすばらしいと思う，…を賞賛する
soccer	サッカー
advice	助言
slowly	ゆっくりと
advise	…にアドバイスする［勧める］
female	雌の，女性の／雌，女性
affect	…に影響を与える
slight	かすかな
afford	…の余裕がある
sleepy	眠い
inform	…に知らせる
market	市場
weight	重さ，体重
market	市場
injury	けが
single	一つの，一人の，独身の
weapon	武器
simply	単に
inside	内側
simple	簡単な，質素な
insist	要求する，主張する
silver	銀
always	いつも
silent	静かな
wander	ぶらつく，放浪する
master	主人，達人／…を習得する
annual	毎年の
farmer	農場主
answer	答える
famous	有名な
intend	意図する，つもりである
signal	信号
vision	未来像，ビジョン
famous	有名な
virtue	徳，美徳，長所
matter	問題，困ったこと
victim	犠牲者
matter	事柄／重要である
verbal	ことばの，口頭での
mature	成熟した
useful	役に立つ
severe	厳しい
arrive	到着する
fairly	かなり，公平に
invent	…を発明する
convey	…を伝える，…を運ぶ
unlike	…とは違って
settle	…を決着させる，落ち着く
invite	招待する
factor	要因，要素
asleep	眠っている
corner	かど
aspect	局面
senior	ポストが上の，上級の／年上の人
hungry	空腹の
senior	年上の，上級の
twelve	12
couple	一対
itself	それ自身
select	…を選び出す
atomic	原子の，原子力の
select	選ぶ
travel	旅行
seldom	めったに…しない
honest	正直な
course	進路
August	８月
cousin	いとこ
toward	…に向かって
create	…を作り出す，…を創造する
avenue	…通り，大通り
medium	中間の
barely	かろうじて
secure	…を確保する，…を安全にする／ゆるぎない
junior	年下の，下級の
extent	程度
beauty	美
extend	延びる，…を拡張する
behave	振る舞う
member	会員
heaven	天
mental	精神の，知的な
ticket	切符
secret	秘密
health	健康
second	2番目の
though	だけれども
crisis	危機
belong	属する
critic	批評家，批判者
happen	起こる
merely	単に
handle	…を手で扱う，…にうまく対処する
season	季節
guitar	ギター
expose	…を明らかにする，…をさらす
theory	理論
method	方法
borrow	…を借りる
middle	中央
branch	枝
search	…を捜す／探索，捜索
theirs	彼(女)らのもの
export	…を輸出する／輸出
bridge	橋
scream	金切り声を上げる
burden	重荷，負担
sailor	船員
latter	後者の
custom	習慣
tennis	テニス
custom	（社会的な）習慣，慣習
Canada	カナダ
runner	ランナー
global	地球の，世界の
damage	被害
gently	やさしく
damage	損害／…に損害を与える
gentle	穏やかな，やさしい
danger	危険
genius	天才
debate	討論
carpet	じゅうたん
decade	１０年
system	体制，体系，組織
minute	分，ちょっとの間
lesson	授業，課
mirror	鏡
letter	手紙
expert	専門家
survey	調査
decide	決心する
gather	…を集める，集まる
defeat	…を負かす
future	未来
defend	…を守る
supper	夕食
define	…の意味を明確に述べる
Sunday	日曜日
degree	程度，度
likely	可能性が高い
ritual	儀式
sudden	突然の
demand	要求，需要／…を要求する
suburb	郊外
modern	現代的な
Friday	金曜日
modern	現代の，近代の
listen	聴く
expect	…を予想する，…を期待する
change	変わる
moment	瞬間，時
little	小さい，幼い，ちょっとした
Monday	月曜日
living	生きている
expand	…を拡大する
strict	厳しい，厳密な
monkey	サル
street	通り
depend	依存する，次第である
charge	非難，料金，管理／…に請求する
reward	褒美，報償／…に褒美［報償］を与える
London	ロンドン
review	論評，批評／…を論評する，…を検討する
choice	選択（肢）
reveal	…を明らかにする
circle	円
return	帰る
former	前の／前者
retire	退職する，引退する
status	社会的地位
retain	…を保持する
forest	森林
motive	動機
square	正方形
result	結果
follow	…の後を追う
excuse	言い訳／…勘弁する
flower	花
excuse	許す
flight	飛行
derive	…を引き出す
firmly	堅く，堅固に
resist	…を拒む，…に抵抗する
luxury	贅沢，贅沢品
report	報告
absent	欠席の
excite	…を興奮させる
impact	影響，衝撃
murder	(故意の）殺人／…を（故意に）殺す
impose	…を課す
museum	博物館
wonder	…かなと思う／驚き
repair	…を修理する
winter	冬
remove	…を取り除く
indeed	実に
mutual	相互の
advice	忠告
remote	遠い
affair	事柄，出来事
myself	私自身を
afraid	恐れて
remind	…に思い出させる
weekly	週刊
remark	ことば，感想／…だと述べる
insect	昆虫
except	…を除いて
almost	ほとんど
remain	…のままである，残る
animal	動物
narrow	幅が狭い
answer	答え
nation	国家，民族，国民
anyway	ともかく
desert	砂漠
appear	現れる，…のように思われる
relief	安堵，軽減
useful	役に立つ
native	生まれ故郷の，生来の
artist	芸術家
reject	…を拒絶する
unique	他に類のない，特別な
region	地域，地方
twenty	20
regard	…を～と見なす
assume	…を当然のことと思う，…を引き受ける
nature	自然
attach	…を貼り付ける，…を取り付ける
nature	自然，性質
attend	…に出席する
nearby	近くの
autumn	秋
refuse	…を拒否する
tongue	言葉，舌
desert	砂漠／…を立ち去る
become	～になる
reduce	…を減らす
behind	…の背後に／背後に
record	レコード
threat	脅威
recent	最近の
thirty	30
reason	理由，理性
borrow	借りる
reason	理由，原因
growth	成長
really	本当に
ground	根拠，理由
desire	願望／…を強く望む
bright	明るい
detail	詳細
butter	バター
device	装置，仕掛け
govern	…を統治する
devise	…を考え出す
career	(生涯にわたる）職業
evolve	進化する
talent	才能
devote	＜時間・努力＞を注ぐ
symbol	象徴
racket	ラケット
center	中央
racial	人種の
surely	確かに
dinner	夕食
sunset	日没
rabbit	ウサギ
suffer	苦しむ，…を患う
direct	直接の
subtle	微妙な
pursue	…を追い求める
chance	機会，可能性，偶然
punish	…を罰する
strike	…を叩く，…に～という印象を与える
public	公共の／大衆
stress	強調，重圧／…を強調する
proper	適切な
cheese	チーズ
profit	利益
choose	選ぶ
prince	王子
forget	忘れる
pretty	かなり
clever	利口な
pretty	かなり
lovely	美しい
ninety	90
spread	広がる，…を広げる
Europe	ヨーロッパ
abroad	外国へ
prefer	…をより好む
import	…を輸入する／輸入
nobody	だれも～ない
action	動作，行動
praise	…をほめる
adjust	…を調節する，順応する
potato	じゃがいも
infant	幼児
polite	礼儀正しい
ignore	…を無視する
policy	政策，方針
amount	量，額
police	警察
visual	視覚の，視覚的な
poison	毒
valley	谷
eraser	消しゴム
unless	…でない限り（原則として）
divide	…を分割する
hunger	飢え，空腹
pocket	ポケット
honest	正直な
plenty	たくさん
barber	床屋
please	…を喜ばせる
height	高さ
please	気に入る，喜ばせる
belong	ものである
notice	…に気づく／注意，掲示
guilty	有罪の
notion	考え，考え方
ground	地面
dollar	ドル
camera	カメラ
planet	惑星
gentle	やさしい
driver	運転手
lesson	授業，教訓
during	～の間，～を通じて
supply	供給／…に供給する
number	数
chance	機会
easily	かんたんに
strong	強い，じょうぶな
object	物体，対象，目的／反対する
locker	ロッカー
editor	編集者
steady	着実な
picnic	ピクニック
spring	春
effect	効果，影響，結果
finish	終える
obtain	…を手に入れる
across	横にさし渡し，横切って
person	人
advise	忠告する，助言する
permit	…を許可する
wealth	富，財産
period	期間，時代
appeal	訴える
people	人々
island	島
pencil	鉛筆
author	著者，作家
occupy	…を占める，…を占領する
behind	…の背後に／背後に
peanut	ピーナッツ
bottle	びん
eighth	8番目の
candle	ろうそく
eighty	80
surely	確かに
entire	全体の，…全体
stupid	馬鹿な
either	(もまた)～でない
lonely	淋しい，ひとりの
offend	…の気分を害する
flight	飛行，（飛行機の）便
eleven	11
actual	現実の，実際の
office	会社，仕事部屋，公職の地位
voyage	航海
palace	宮殿
assure	…に～だとして安心させる
emerge	現れる
border	国境
ensure	…を確実にする，…を保証する
casual	何気ない
enough	十分な
strike	打つ
employ	…を雇う
accent	（ことばの）なまり，抑揚
output	生産量，産出量
invent	発明する
enable	…に可能にさせる
latest	最新の，最近の
oppose	…に反対する
energy	エネルギー
endure	…に耐える
origin	起源
summer	夏
highly	とても，高く
afraid	心配して，怖がって
statue	像
machine	機械
abandon	…を捨て去る
disease	病気
morning	朝
compare	…を比較する，…をたとえる
mineral	鉱物
hundred	百
opinion	意見
primary	最初の，主要な，最優先の
imitate	…を模倣する
compete	競争する
average	平均の／平均
society	社会
holiday	休日
evening	晩
himself	彼自身
fifteen	15
England	イングランド
husband	夫
English	英語
discuss	…について議論する
herself	彼女自身
private	個人的な，私的な
healthy	健康な
complex	複雑な
believe	信じる
discuss	話し合う
thought	考えること，考え
isolate	…を孤立させる
thought	考え
compose	…を構成する，＜曲や詩＞を作る
harmony	調和
problem	問題
harmful	有害な
problem	問題
beneath	…の下に
proceed	進む
happily	幸せに，楽しく
process	過程／…を加工処理する
between	～と～の間
produce	…を生みだす，…を生産する
billion	１０億
product	製品，産物
largely	主として
typical	典型的な
breathe	呼吸をする
feeling	感覚
tragedy	悲劇
welcome	歓迎される／…を歓迎する
grammar	文法
welcome	ようこそ
tension	緊張
concert	コンサート
passive	受身の，消極的な
program	番組
genuine	本物の，偽りのない
program	（実施）計画，プログラム
capable	可能性がある，しかねない，有能な
conduct	行為／…を行う
o'clock	～時
project	計画，事業
capital	首都
promise	約束
captain	船長
promote	…を促進する
careful	注意深い
undergo	…を経験する
achieve	…を達成する
confine	…を限る，…を閉じこめる
percent	パーセント
sixteen	16
perform	…を行う，機能する
confirm	…を確認する
swallow	…を飲み込む
confuse	…を混乱させる
survive	（…を切り抜け）生き残る
initial	当初の
liberal	（他の思想に）寛大な，自由主義的な
propose	…を提案する
impress	…に感銘を与える
married	結婚した，既婚の
garbage	（生）ゴミ，くず
protect	…を守る
impulse	衝動
protest	抗議する／抗議
central	中心の
feature	特徴／…を目玉とする
observe	…を観察する，…を遵守する
similar	よく似た
funeral	葬式
proverb	ことわざ
century	世紀
provide	…を［…に］与える
include	…を含む
weather	気候，天気
fulfill	…を果たす，…をかなえる
connect	…をつなげる
certain	ある
publish	…を出版する
pioneer	開拓者，先駆者
massive	巨大な，大規模な
suggest	…を提案する，…を示唆する
weather	天気
success	成功，成功したもの［人］
unhappy	不幸な
success	成功
purpose	目的
journey	旅
ashamed	恥じて
subject	科目，題目
pursuit	追跡，追求
divorce	離婚
involve	…を含む，…を巻き込む
nothing	何も～ない
consist	成り立つ，存在する
pleased	喜んで
quality	質
strange	奇妙な，見知らぬ
unknown	未知の，無名の
however	しかし
wealthy	裕福な
chicken	ニワトリ
consume	…を消費する
Chinese	中国の，中国人の
contact	…と連絡をとる／接触，連絡
January	１月
quickly	すばやく
address	住所，演説／…の前で演説をする
contain	…を含む，…が入っている
disturb	…の平穏を妨げる
quietly	静かに
athlete	運動選手
insight	深く正確な理解，洞察（力）
popular	人気のある，大衆の
unusual	めずらしい，普通でない
forever	永遠に
content	中身，目次／満足して
foreign	外国の
airport	空港
climate	気候
inspire	…を鼓舞する
closely	綿密に，密接に
contest	コンテスト
whisper	ささやく
evident	明らかな
fishing	魚釣り
shelter	避難，避難場所
clothes	服
arrange	（…を）計画・準備する
finally	ついに
railway	鉄道
display	…を展示する／展示
dignity	威厳，尊厳
species	（動植物の）種
already	すでに
special	特別な
rainbow	虹
collect	集める
control	支配，制御／…を支配［制御］する
collect	…を集める，…を徴収する
useless	役に立たない
college	大学
convert	…を変える，変わる
combine	…を結合させる
seventy	70
Tuesday	火曜日
dialect	方言，なまり
command	…に［を］命じる／行使する力
rapidly	素早く
present	出席している，現在の
nervous	あがっている，神経質な
someone	だれか
neither	～も～も(ない)
disease	病気
seventh	7番目の
twelfth	１２番目の
usually	ふつう
prevent	…を妨げる
amazing	びっくりするような
imagine	…を想像する
develop	…を発達［発展］させる，発達する
totally	完全に
failure	失敗，失敗作，失敗者
tonight	今夜(は)
factory	工場
justify	…を正当化する
servant	使用人，お手伝い
healthy	健康（的）な
destroy	…を破壊する
harvest	収穫／…を収穫する
serious	真剣な，深刻な
emotion	感情
destroy	破壊する
painter	画家
readily	すぐに
besides	その上
despite	…にもかかわらず
element	要素
correct	正確な／…を訂正する
traffic	交通，往来／交通の
reality	現実
passage	（文章の）一節，通路
realize	理解する，実現する
attract	…を引きつける
realize	…だとわかる，…を実現する
patient	我慢強い／患者
neglect	…の世話を怠る，…を省みない
capital	資本，資本金，首都／大文字の
extreme	極端な
leisure	余暇
exactly	正確［厳密］に，ちょうど
acquire	…を身につける
America	アメリカ
suspect	…を疑う，…ではないかと思う／容疑者
receive	受け取る
surface	表面
receive	…を受け取る
improve	…を改善する
examine	…を検査する，…を調べる
suppose	…だと思う，…だと仮定する
meaning	意味
physics	物理学
courage	勇気
picture	絵，写真
courage	勇気
certain	ある…，確信している
measure	措置，測るもの／…を測る
nuclear	核の
variety	多様
succeed	成功する
medical	医学の，医療の
freedom	自由
recover	回復する
located	（ある場所に）位置する
mention	…について言及する
strange	奇妙な
various	さまざまな
willing	いとわない，やぶさかでない
express	…を表現する
forward	前方へ
science	科学
citizen	市民
reflect	…を反映する，熟考する
advance	前進する／前進，事前
analyze	…を分析する
portion	部分
science	科学
possess	…を所有する
scholar	学者
distant	遠く離れた
ancient	古代の，大昔の
dispute	争議，口論
natural	当然の，自然の
however	しかしながら
scatter	…をまき散らす
dislike	嫌う
natural	自然の
predict	…を予想する，…を予測する
related	関係している，関連した
prepare	準備をする，…に準備をさせる
culture	文化
manager	部長，支配人，監督
satisfy	…を満足させる
pretend	…のふりをする
culture	文化
soldier	兵士
release	…を解き放つ
history	歴史
curious	好奇心が強い
outside	外側の
current	現在の，目下の／流れ
emperor	皇帝，天皇
relieve	…を和らげる，…から取り除く
benefit	利益／…に利益をもたらす
curtain	カーテン
theater	劇場
million	１００万
passion	熱望，強い関心
example	例
account	説明，口座／説明する，占める
million	百万
general	一般的な，全般的な
another	ほかの，もうひとつの
obvious	明白な
explore	…を探索［探検］する
witness	目撃者，証人／…を目撃する
vehicle	乗り物，伝達手段
educate	…を教育する
explain	…を説明する
ecology	生態（学）
engaged	従事している，婚約している
subject	話題，主題
musical	音楽の
attempt	試み／…を試みる
explain	説明する
address	住所
replace	…に取って代わる
popular	人気のある
anxiety	心配，不安
climate	気候
routine	いつもの／いつもの手順
imagine	想像する
excited	興奮した
special	特別の
roughly	大雑把に
whereas	…である一方で
declare	…を宣言する
somehow	どうにか
visitor	訪問者
history	歴史
request	…を依頼する／依頼
absence	不在，欠如
require	…を必要とする
bicycle	自転車
anxious	心配して，切望する
October	１０月
decline	…を断る，衰退する／低下，衰退
perhaps	多分
reserve	…を取っておく，…を予約する
support	…を支持［支援］する／支持，支援
mistake	誤り
dressed	服を身につけた
mistake	誤り／…を～と間違える
logical	論理的な
resolve	…を解決する，決心する
forever	永久に
respect	尊敬，尊重，点／…を尊敬する
dislike	…を嫌がる／嫌悪
respond	反応する，返答する
present	プレゼント
version	…版，別形式
because	なぜなら
visible	目に見える
elderly	年配の
delight	喜び
liberty	自由
depress	…を落胆させる
stretch	広がる／広がり
deliver	…を配達する
foolish	愚かな
company	会社，仲間
exhaust	…を疲れ果てさせる，…を使い果たす
monthly	月刊
exhibit	…を表に出す，…を展示する，
expense	費用，出費，犠牲
painful	苦痛な
precise	正確な
fortune	運，財産
economy	経済
capture	…を捕える
engineer	エンジニア
disaster	災害
division	分割，部門
universe	宇宙
exercise	運動，練習／運動をする
consider	…について考える，…を～だと見なす
ordinary	普通の
peculiar	奇妙な
mountain	山
identify	…を見分ける
baseball	野球
material	材料，原料／物質（的）な
tomorrow	明日
generous	気前のよい
together	一緒に
purchase	…を購入する／購入
violence	暴力
attitude	考え方，態度
apparent	外見上の，明らかな
accurate	正確な
definite	明確な
everyone	みんな
movement	動き，（政治的・社会的）運動
category	部門，部類
decrease	減少する／減少
generate	…を発生させる
overcoat	オーバー
opposite	反対の／…と反対側の
decision	決定，決心
favorite	一番好きな，一番好きなもの
describe	…について述べる，…を描写する
discover	発見する
minority	少数派
perceive	…を知覚する
overcome	…を克服する
prospect	見通し，見込み
remember	…を覚えている，…を思い出す
property	財産，所有地
customer	顧客
confront	…を直面させる
national	国家の，国民の
conflict	対立，争い
religion	宗教
occasion	（特定の）時，場合
reliable	頼りになる
properly	適切に
enormous	非常に大きい
survival	生存
thousand	千
personal	個人の
Saturday	土曜日
discover	…を発見する
homeroom	ホームルーム
surround	…を取り囲む
absolute	絶対的な，完全な
umbrella	かさ
elephant	象
progress	進歩
yourself	あなた自身
surprise	…を驚かせる／驚き
birthday	誕生日
ultimate	究極の
critical	極めて重要な，非常に深刻な
conclude	締めくくる，…という結論を下す
homework	宿題
profound	深い，大きな
merchant	商人
personal	個人的な，個人の
language	ことば，言語
February	２月
security	安心，安全，治安
persuade	説得する
creation	創造，創造物
slightly	わずかに
abstract	抽象的な
inferior	劣った
valuable	貴重な
festival	祭り
textbook	教科書
computer	コンピュータ
recently	最近
transfer	…を移す
negative	否定の，否定的［悲観的］な
probably	おそらく
neighbor	隣人
probably	多分
sensible	分別［判断力］がある
incident	事件
sentence	文
suppress	…を抑える
business	商売
complete	完全な
ambition	夢，大望
inclined	傾いている，傾向がある
convince	…に納得させる
complain	不満を言う
graduate	卒業する
physical	身体の，物理的な
rational	理性的な
superior	より優れた
although	…だけれども
function	機能／機能する
although	であるけれど
socially	社会的に
campaign	政治的運動
activity	活動
passport	パスポート
suitable	適した
diminish	減る，…を減らす
economic	経済の，経済的な
contrary	反対の
numerous	多数の
contract	契約
previous	前の
patience	辛抱強さ，忍耐
nineteen	19
capacity	最大容量［積載量・稼働力］，能力
solution	解決（法）
disagree	一致しない
frontier	国境，辺境
unlikely	可能性が低い
suddenly	突然
peaceful	平和な
industry	産業，工業
shoulder	肩
frighten	…をおびえさせる，…を怖がらせる
quantity	量
entrance	入り口，入学
constant	絶え間ない
dramatic	劇的な
organize	…を組織する
November	１１月
restrict	…を制限する
somewhat	いくぶん
delicate	微妙な
humanity	人間，人間性
hesitate	ためらう
commonly	一般に
resident	居住者
preserve	…を保存［保護］する
reporter	レポーター
friendly	友好的な
December	１２月
friendly	好意的な
overlook	…を見落とす，…を見過ごす
majority	大多数，大半
Thursday	木曜日
presence	存在
national	国の，国立の
dominate	…を支配する
relative	相対的［比較的］な
estimate	…を推定する，…を見積もる／推定
relation	関係
maintain	…を維持する，…だと主張する
elevator	エレベーター
domestic	国内の，家庭内の
appetite	食欲
precious	貴重な
midnight	真夜中
exercise	練習する
language	言語
practice	練習，慣習，実行
creative	創造的な
practice	練習する
accident	事故
wherever	…する所はどこでも
American	アメリカの
astonish	…をびっくりさせる
building	建物
increase	…を増やす，増える
terrible	ひどい，不快な
specific	具体的な，特定の
reaction	反応　
literary	文学の
neighbor	近所の人
struggle	もがき苦しむ
instinct	本能
spelling	綴り
laughter	笑い
treasure	宝物
approach	…に近づく
magazine	雑誌
training	トレイニング
frequent	頻繁な
evidence	証拠
indicate	…を指し示す
eighteen	18
distance	距離
shortage	不足
possibly	ひょっとすると
universe	宇宙
possible	可能な
original	当初の／原文
football	フットボール
bathroom	浴室
positive	自信のある，肯定的な
research	研究，調査
position	位置，立場，地位
exchange	交換／…を交換する
position	位置，地位
employee	従業員
standard	標準，基準
eleventh	11番目の
distinct	はっきり異なる
ancestor	祖先
document	文書
merchant	商人
treasure	宝，財宝
medicine	薬
pleasant	楽しい，気持ちのよい
recently	最近
notebook	ノート
separate	分離した／…を切り離す
tropical	熱帯（地方）の
calendar	カレンダー
pleasure	楽しみ，喜び
audience	聴衆，観客，視聴者
strength	力，強さ
continue	…を続ける
adequate	十分な
question	質問
district	地域，地区
internal	内部の
Atlantic	大西洋の
response	反応，返答
steadily	着実に
remember	思い出す，覚えている
politics	政治
thirteen	13
location	位置，場所
external	外部の
stranger	見知らぬ人，（ある場所に）初めて来た人
facility	施設，設備
stranger	見知らぬ人
familiar	馴染みのある
actually	実際に，現実に
directly	直接（的）に
equality	平等
exciting	興奮させる
normally	通常は，正常に
threaten	…を脅かす
intimate	親密な
fourteen	14
addition	付加，追加
chemical	化学の／化学製品
straight	まっすぐに
vacation	休暇
military	軍隊の，軍事の
behavior	行動，振る舞い
entirely	完全に，全く
contrast	対照
establish	…を設立する
accompany	…に付き添う
available	利用できる，人の手があいている
candidate	候補者，志願者
treatment	扱い，処置，治療
technical	技術上の，専門的な
policeman	警官
evolution	進化，進展
political	政治の，政治的な
telescope	望遠鏡
long-term	長期的な
difficult	むずかしい
advertise	…を宣伝［広告］する
introduce	…を紹介する，…を導入する
civilized	発達した文明をもつ
introduce	紹介する，初めて伝える
classroom	教室
gradually	次第に
character	性格，特質
different	違った
structure	構造
passenger	乗客
potential	潜在的な
seventeen	17
household	（一つ屋根の下で暮らす）家族，家
determine	…を決める
precisely	正確に
September	９月
prejudice	先入観，偏見
sensitive	敏感な，神経質な
fifteenth	１５番目の
territory	領土
something	何か
elaborate	手の込んだ
president	社長，大統領，学長
extremely	極端に
community	共同社会
broadcast	…を放送する
translate	…を翻訳する
recognize	…がそれ（その人）だとわかる
affection	愛情
brilliant	すばらしい
primarily	主として
important	重要な
economics	経済学
recommend	…を薦める
education	教育
yesterday	昨日
transform	…を変える
immigrant	移民
principle	原理・原則，主義
breakfast	朝食
complaint	不満
necessity	必要，必要なもの
privilege	特権
desirable	望ましい
identical	全く同じ
necessary	必要な
wonderful	すばらしい
tradition	伝統
condition	状態，条件
landscape	風景
sixteenth	１６番目の
guarantee	…を保証する
obviously	明らかに
necessary	必要な
situation	状況，情勢
therefore	それゆえ
celebrate	…を祝う
knowledge	知識
Wednesday	水曜日
scientist	科学者
conscious	意識して，気づいて
Australia	オーストラリア
agreement	同意，一致
reference	言及，参照
efficient	効率［能率］の良い
naturally	当然，自然に
universal	普遍的な，万国［万人］共通の
regularly	規則的に，定期的に
invisible	見えない
criticism	批判
direction	方向，方角
criticize	…を批判する
stimulate	…を刺激する
cultivate	…を耕作する，…を栽培する
Christmas	クリスマス
thirtieth	３０番目の
statement	話，陳述，声明
entertain	…を楽しませる
spiritual	精神の，精神的な
insurance	保険
financial	財政の，金融の
eliminate	…を取り除く
practical	実用的な，実際的な
happiness	幸福
committee	委員会
embarrass	…を恥ずかしがらせる，…にばつの悪い思いをさせる
president	大統領
immediate	即座の
companion	連れ，仲間
emotional	感情の，感情的な
certainly	確かに
emphasize	…を強調する
primitive	原始的な
vegetable	野菜
principal	第一の，主要な／校長，学長
curiosity	好奇心
effective	効果的な
explosion	爆発
influence	…に影響を及ぼす／影響
sacrifice	犠牲／…を犠牲にする
afternoon	午後
kilometer	キロメートル
permanent	永久の，常設の
exception	例外
generally	一般的に
volunteer	ボランティア，志願兵
newspaper	新聞
excessive	過度の
gentleman	紳士
interrupt	…の邪魔をする，…を中断させる
disappear	消える
represent	…を表す，…を代表する
essential	不可欠な
ourselves	私たち自身を
classical	古典の，古典的な
encounter	…に遭遇する
literally	文字通りに
interpret	…を解釈する，通訳する
sometimes	時々
beautiful	美しい
challenge	挑戦，難題／…に異議を唱える
expensive	値段が高い
twentieth	２０番目の
authority	権威
associate	…を結びつけて考える
delicious	おいしい
everybody	だれでもみな
interfere	干渉する，阻害する
fascinate	…を魅了する
democracy	民主主義
construct	…を組み立てる，…を建造する
otherwise	さもなければ，それとは違うように
advantage	有利，利点
encourage	…を励ます，…を助長する
substance	物質
originate	起こる，生じる
Westerner	西洋人，西部に住む人
virtually	実質的に
concerned	関わっている，心配している
carefully	注意深く
executive	幹部，重役
dependent	依存している
operation	操作，運転，手術
judgement	判断
continent	大陸
confusion	混乱
furniture	家具，調度品
transport	…を輸送する／輸送
colleague	同僚
similarity	類似（点）
population	人口，国民
remarkable	目立った，顕著な
possession	所有，所有物
background	背景，経歴
individual	個人の，個々の／個人
basketball	バスケットボール
industrial	産業の，工業の
biological	生物学上の
preference	好み
themselves	彼(女)ら自身
constantly	常に
elementary	初歩の，基本の
university	大学
acceptance	受け入れ
constitute	…を構成する
illustrate	…を詳しく説明する
nineteenth	１９番目の
government	政府，統治
investment	投資
generation	世代
inevitable	避けられない
electrical	電気の
unpleasant	不愉快な
limitation	制限，制約
discussion	議論
substitute	…を代わりに使う／代わり
discussion	討論
literature	文学
artificial	人工的な
strengthen	…を強化する
production	生産，製造
eighteenth	１８番目の
well-known	よく知られた
foundation	土台，根拠，設立
contribute	寄付する，貢献する
occupation	職業
profession	職業
statistics	統計
eventually	最終的には
specialist	専門家，専門医
convenient	都合がよい
accustomed	慣れている
convention	しきたり，（大規模な）会議
impression	印象
inhabitant	（ある場所の）居住者，生息動物
comparison	比較
proportion	比率，割合
obligation	義務
aggression	攻撃性
equivalent	等しい，同等の
discourage	…をがっかりさせる
additional	追加の
punishment	罰
conference	会議
mechanical	機械の，機械的な
confidence	自信，信頼
aggressive	攻撃的な，積極的な
widespread	広範囲に渡る
extinction	絶滅
unexpected	予期せぬ
expression	表現
automobile	自動車
scientific	科学の
laboratory	実験室
appearance	出現，外見
absolutely	絶対に
everything	すべてのもの
attractive	魅力的な
discipline	しつけ，規律
centimeter	センチメートル
experiment	実験
enthusiasm	情熱，熱意
disappoint	…をがっかりさせる
fourteenth	１４番目の
definition	定義
tremendous	非常に大きな
everywhere	どこでも
impossible	不可能な，だめな
difficulty	困難，苦労
assumption	想定，思いこみ
experience	経験／…を経験する
phenomenon	現象
difference	違い
complexity	複雑さ
democratic	民主主義の，民主的な
conclusion	結論
revolution	革命
understand	理解する
restaurant	レストラン
popularity	人気
dictionary	辞書
enterprise	会社，事業
altogether	完全に
technology	テクノロジー，科学技術
reasonable	理性のある，理にかなった
frequently	頻繁に
reputation	評判
atmosphere	雰囲気
interested	興味のある
perception	洞察（力），知覚
historical	歴史（上）の
especially	特に
vocabulary	語い
politician	政治家
reflection	反映，反射
particular	特定の，特にその，気むずかしい
accomplish	…を成し遂げる
instrument	道具，器具
regardless	かかわらず，関係なく
mysterious	不可解な
volleyball	バレーボール
specialize	専門にする，専攻する
sufficient	十分な
thirteenth	１３番目の
especially	特に
philosophy	哲学
description	説明，描写
significant	重要な
imagination	想像
comfortable	心地の良い
concentrate	集中する
acknowledge	…の存在［正しさ］を認める
intelligent	知能の高い
communicate	意思を伝える，…を伝達する
recognition	その人［それ］だとわかること
information	情報
destruction	破壊
appropriate	適当な，適切な
opportunity	機会
arrangement	準備，取り決め
responsible	責任がある
personality	人格，性格，（芸能界などの）有名人
alternative	代替となるもの／代替の
investigate	（…を）調査する
immediately	即座に
association	協会，組合
agriculture	農業
consumption	消費
immigration	（他国からの）移住
perspective	見地，視座
traffic jam	交通渋滞
effectively	効果的に
grandfather	祖父
philosopher	哲学者
cooperation	協力
practically	実質的に，ほとんど
appointment	約束
manufacture	製造する
instruction	指示，指導
consequence	結果
requirement	要求される事柄，必要なもの
essentially	本質的に
interesting	おもしろい
educational	教育の，教育的な
grandmother	祖母
distinction	区別，違い
participate	参加する
observation	観察
application	応用，適用
necessarily	必然的に
seventeenth	１７番目の
independent	独立した，自立した
institution	制度，慣習，（重要な）施設
competition	競争，競争相手
traditional	伝統的な
distinguish	…を区別する
explanation	説明　
composition	構成，楽曲
undoubtedly	疑いなく
complicated	複雑な
environment	環境
temperature	温度，体温
participant	参加者
development	発展，発達
fundamental	基本的な，根本的な
relationship	関係
intelligence	知能，諜報
professional	専門職の／専門職の人
satisfactory	満足のいく
acquaintance	知り合い
circumstance	（周囲の）状況
contribution	寄付，貢献
unemployment	失業
occasionally	時折
intellectual	知的な，知性の
conversation	会話
consequently	その結果
civilization	文明
organization	組織，団体
increasingly	ますます
construction	建設，構造
characterize	…を特徴づける
introduction	紹介，導入
deliberately	故意に
independence	独立，自立
considerable	かなりの
psychologist	心理学者
particularly	特に
disadvantage	不利，デメリット
nevertheless	にもかかわらず
overwhelming	圧倒的な
significance	重要性，意義
neighborhood	近所
contemporary	現在の，現代の，同時代の
unfortunately	残念なことに
traditionally	伝統的に
uncomfortable	心地の悪い
entertainment	娯楽
extraordinary	普通でない，並はずれた
pronunciation	発音
environmental	環境の
communication	コミュニケーション，意思の伝達
industrialize	…を産業化［工業化］する
international	国際的な
misunderstand	…を誤解する
international	国際的な
characteristic	特徴
transportation	輸送